Mm, Mm, Mm^Xm, Hh, Mm, Hh, Hh, Hh, Mm, Mm, Mm^Xm, Mm, Mm, Gg, Gs^Fp, Gg, Hh, Gg, Gs^Fp, Gg, Gs^Fp, Gg, Mm, Mm, Mm^Xm, Mm, Mm, Hh, Hh, Hh, Mm^Xm, Mm, Mm, Mm, Hh
Mm, Mm, Mm^Xm, Mm^Xm, Mm, Mm, Hh, Hh, Hh, Mm, Mm, Mm^Xm, Mm^Xm, Mm, Mm, Gs^Fp, Gg, Gg, Gg, Hh, Mm, Mm, Mm^Xm, Mm^Xm, Mm, Mm, Hh, Hh, Mm, Mm^Xm, Mm^Xm, Mm^Xm, Mm^Xm, Mm, Mm^Xm
Mm^Xm, Mm^Xm, Mm, Mm, Hh, Hh, Hh, Hh, Hh, Hh, Hh, Mm, Mm, Mm^Xm, Mm^Xm, Hh, Chr, Gg, Chr, Gg, Mm^Xm, Mm^Xm, Mm, Mm, Hh, Hh, Hh, Mm, Mm, Mm, Mm, Mm^Xm, Mm, Mm^Xm, Hh
Mm, Mm, Hh, Hh, Hh, Hh, Gg, Hh, Gg, Gg, Hh, Gg, Hh, Mm, Hh, Chr, Gg, Chr, Gg, Chr, Hh, Mm, Hh, Hh, Hh, Hh, Hh, Mm, Hh, Hh, Hh, Hh, Hh, Hh, Gg
Hh, Mm, Hh, Hh, Hh, Gg, Gg, Gg, Gs^Fp, Gg, Gg, Gg, Gg, Hh, Gg, Chr, Gg, Chr, Gg, Chr, Gg, Hh, Gg, Hh, Hh, Hh, Hh, Hh, Hh, Hh, Hh, Hh, Hh, Hh, Gg
Hh, Hh, Hh, Hh, Hh, Gg, Gg, Gs^Fp, Hh, Gs^Fp, Gs^Fp, Gg, Gg, Gg, Gg, Gg, Gg, Gg, Gg, Gg, Gg, Gg, Gs^Fp, Gg, Gg, Hh, Hh, Hh, Hh, Hh, Hh, Hh, Gg, Gg, Gg
Hh, Hh, Hh, Hh, Gg, Hh, Gg, Gg, Hh, Hh, Gs^Fp, Gg, Gg, Gg, Gg, Gg, Gg, Gg, Gg, Gg, Gs^Fp, Gs^Fp, Hh, Gs^Fp, Gg, Hh, Hh, Hh, Hh, Hh, Gg, Gg, Gg, Gs^Fp, Gg
Hh, Hh, Hh, Hh, Gg, Gg, Gg, Hh, Gg, Gg, Gg, Gg, Gg, Gg^Vc, Gg, Gg, Gg, Gg, Gg, Gg, Gg, Gs^Fp, Gg^Vc, Hh, Gs^Fp, Gg, Gg, Hh, Hh, Hh, Gg, Gg, Gs^Fp, Gs^Fp, Gg
Hh, Hh, Hh, Gg, Gs^Fp, Gs^Fp, Gg, Gs^Fp, Gs^Fp, Gg, Gg, Gg, Gg, Gg, Gg, Gg, Gg, Gg, Ww, Gg, Gg, Gg, Gg, Gg, Gs^Fp, Gg, Gg, Hh, Gg, Hh, Gg, Gg, Gs^Fp, Gs^Fp, Gs^Fp
Hh, Hh, Gg, Gg, Gg, Gs^Fp, Gg, Gg, Gg, Gg, Gg, Gg, Gg, Ww, Ww, Ww, Ww, Ww, Ww, Ww, Gg, Gg, Gg, Gg, Gg, Gs^Fp, Gg, Gg, Gg, Gg, Gg, Gg, Gg, Gs^Fp, Gs^Fp
Gg, Gg, Gg, Gg, Gg, Gg, Gg^Vc, Gg, Gg, Gg, Gg, Gg, Ww, Ww, Ww, Ww, Ww, Ww, Ww, Ww, Ww, Ww, Ww, Ww, Ww, Gg, Gg, Gg, Gg^Vc, Gg, Gg, Gg, Gg, Gg, Gg
Gg, Gg, Ce, Gg, Gg, Gg, Gg, Gg, Gg, Gs^Fp, Gs^Fp, Ww, Ww, Ww, Ww, Ww, Ww, Ww, Ww, Ww, Ww, Ww, Ww, Ww, Ww, Gg, Gg, Gg, Gg, Gg, Gg, Gg, Ce, Gg, Gg
Gg, Re^Gvs, 1 Ke, Ce, Gg, Gg, Gg, Gg, Hh, Hh, Gg, Ww, Ww, Ww, Ww, Ww, Ww, Ww, Ww, Ww, Ww, Ww, Ww, Ww, Ww, Gs^Fds, Gg, Gg, Gg, Gg, Gg, Ce, 2 Ke, Re^Gvs, Gg
Gg, Gg, Ce, Ce, Gg, Gg, Ww, Gg, Gs^Fp, Gs^Fp, Ww, Ww, Ww, Ww, Ww, Ww, Ww, Ww, Ww, Ww, Gg, Ww, Gg, Ww, Gg, Gg, Gg, Gg, Gg, Gg, Gg, Ce, Ce, Gg, Gg
Gg, Gg, Gg, Gg, Gg, Ww, Ww, Ww, Ww, Gg, Gg, Ww, Ww, Ww, Ww, Ww, Ww, Ww, Ww, Gg, Gs^Fp, Gg, Gs^Fp, Gg, Gg, Gg, Gg, Gs^Fp, Gs^Fp, Gg, Gg, Gg, Gg, Gg, Gg
Gg, Gg, Gg, Gg, Gg, Ww, Ww, Ww, Ww, Gg, Gg^Vc, Gs^Fp, Gg, Ww, Ww, Ww, Gg, Ww, Gg, Gg, Gg, Gs^Fp, Gg, Gg^Vc, Gg, Gg, Gg, Gs^Fp, Gg, Gs^Fp, Gg, Gg, Gs^Fp, Ss, Gs^Fp
Gg, Gg, Gg, Gg, Gg, Wwf, Wwf, Ww, Gg, Gg, Gg, Gg, Gg, Ww, Ww, Ww, Gg, Gs^Fp, Gs^Fp, Gg, Gg, Gg, Gg, Gg, Hh, Hh, Hh, Gg, Gg, Gg, Gg, Gg, Ss, Ss, Gs^Fp
Gs^Fp, Gs^Fp, Gg, Gg, Gg, Hh, Gs^Fp, Gg, Gg, Gs^Fp, Gg, Gg, Ww, Ww^Bw\, Gg, Gg, Gg, Gs^Fp, Gg, Gg, Gg, Hh, Hh, Hh, Hh, Hh, Mm, Hh, Hh, Gg, Gg, Gg, Gs^Fp, Ss, Gs^Fp
Gs^Fp, Gs^Fp, Gg, Gg^Vc, Gg, Gg, Gg, Gg, Gg, Gs^Fp, Gs^Fp, Gs^Fp, Ww, Ww, Gg, Gg, Gg, Gg, Gg, Gg, Gg, Hh, Hh, Mm, Hh, Mm, Mm, Mm, Hh, Gg, Gg, Gg^Vc, Gg, Ss, Gs^Fp
Gs^Fp, Gs^Fp, Gg, Gg, Gg, Gg, Gg, Gg, Hh, Hh, Gg, Ww, Ww, Ss, Gg, Gg, Gg, Gg, Gg, Gg, Gg, Gg, Hh, Hh, Hh, Mm, Hh, Hh, Gg, Gg, Gg, Gg, Gs^Fp, Gg, Gs^Fp
Gg, Gg, Gg, Gg, Gg, Gg, Gg, Gg, Mm, Gs^Fp, Ss, Ww, Ww, Gg, Hh, Gg, Gs^Fp, Gg, Gg, Gg, Gg, Gg, Gg, Hh^Vhh, Hh, Hh, Hh, Hh, Gg, Gg, Gs^Fp, Gg, Gs^Fp, Ss, Ss
Hh, Hh, Hh, Gg, Gg, Gg, Gs^Fp, Hh, Hh, Hh, Ss, Ww, Gg^Vh, Hh, Mm, Gg, Gs^Fp, Gs^Fp, Gg, Gg, Gg, Gs^Fp, Gg, Gg, Gg, Gg, Gg, Gg, Gg, Gg, Hh, Hh, Gs^Fp, Ss, Ss
Hh, Hh, Hh, Gg, Gg, Hh, Gs^Fp, Gs^Fp, Gg, Ss, Ww, Ww, Gg, Gs^Fp, Gs^Fp, Hh, Gg, Gs^Fp, Gg, Gg, Gg, Hh, Hh, Gg, Gg, Gg, Ds, Gg, Gg^Vh, Gg, Gg, Gg, Gs^Fp, Ss, Gg
Hh, Mm, Mm, Hh, Gg, Gg, Gg, Gg, Gg, Ss, Ww, Ss, Gg, Gg, Gg, Gg, Gg, Gg, Gg, Gg, Gg, Gs^Fp, Ww, Ds, Ww, Ww, Ww, Gg, Gs^Fp, Gs^Fp, Gs^Fp, Gg, Ss^Bw\, Ss, Gg
Hh, Hh, Hh, Hh, Gg^Vh, Gg, Gg, Gg, Gg, Ss, Ww, Ss, Ss, Gg, Gg, Gg, Gs^Fp, Gg, Gg, Gg, Ds, Ww, Ww, Ww, Ww, Ww, Ww, Gs^Fp, Ss, Ss^Fmw, Ss, Ss, Ss, Gg, Gg
Hh, Hh, Gg, Gg, Gg, Gg, Gg, Gg, Gg, Gg, Ww, Ww, Gg, Gg, Gg, Gs^Fp, Hh, Gs^Fp, Hh, Gg, Gg, Ww, Ww, Ww, Ww, Ww, Ww, Ss, Ss, Ss, Ss, Ss, Gs^Fp, Gs^Fp, Gs^Fp
Gg, Gg, Gg, Gg, Gg, Gs^Fp, Gs^Fp, Gg, Gs^Fp, Gg, Ww, Ww, Ww, Gg, Gg^Vh, Gg, Gg, Mm, Gs^Fp, Gg, Gg, Gg, Gg, Ww, Gs^Fp, Ww, Gs^Fp, Gs^Fp, Ss^Fmw, Ss, Ss^Fdw, Ss, Ss^Vhs, Gs^Fp, Gs^Fp
Gs^Fp, Gg, Gg, Gg, Gg, Gs^Fp, Gs^Fp, Hh, Hh, Gs^Fp, Gs^Fp, Ww, Ww, Gg, Gg, Gg, Gg, Hh, Gg, Gg, Gg^Vh, Gs^Fp, Gs^Fp, Gs^Fp, Gs^Fp, Ds, Gg, Gs^Fp, Gs^Fp, Ss, Ss^Fmw, Ss, Gs^Fp, Gg, Gg
Gg, Gs^Fp, Gs^Fp, Gg, Gs^Fp, Gs^Fp, Hh, Hh, Hh, Gg, Gg, Ww, Ww, Gg, Gg, Gg, Gg, Gg, Gg, Gg, Gs^Fp, Gs^Fp, Hh, Hh, Hh, Gs^Fp, Hh, Gg^Vh, Gs^Fp, Ss, Ss^Fdw, Ss^Fdw, Ss, Ss, Gs^Fp
Ss, Gs^Fp, Gs^Fp, Gg, Gs^Fp, Gg, Hh, Hh, Gg, Gg, Ww, Ww, Ss, Gg, Gg, Gg, Gg, Gg, Co, Co, Co, Gs^Fp, Gs^Fp, Mm, Mm, Hh, Hh, Gs^Fp, Ss^Fmw, Ss, Ss, Gs^Fp, Gs^Fp, Ss, Ss
Gs^Fp, Ss, Ss, Gs^Fp, Gs^Fp, Gg, Hh, Hh, Gs^Fp, Gs^Fp, Ww, Ww, Ss, Ss, Gg, Gg, Gg, Co, Co, Co, Co, Co, Gg, Hh, Hh, Mm, Hh, Gs^Fp, Ss, Ss, Ss^Fdw, Ss, Gs^Fp, Gs^Fp, Ss
Ss, Ss, Ss, Gg, Gg, Hh, Gg, Gg, Gs^Fp, Gg^Vh, Ww, Ww, Gs^Fp, Ss, Gs^Fp, Gg, Gg, Gg, Gg, Ko, Gg, Gg, Gs^Fp, Gs^Fp, Ss, Gs^Fp, Ss, Gs^Fp, Ss, Ss, Ss, Ss, Ss, Gs^Fp, Ss
Ss, Gg, Ss^Vhs, Ss, Ss, Gs^Fp, Ss, Gs^Fp, Ww, Ww, Ww, Ss, Gs^Fp, Gs^Fp, Gs^Fp, Gg, Gg, Gg, Gg, Gg, Gg^Vh, Gg, Ss, Ss, Gs^Fp, Ss, Gs^Fp, Ss, Ss, Ss^Fdw, Ss, Gs^Fp, Gs^Fp, Gs^Fp, Gs^Fp
Gg, Gg, Gs^Fp, Ss, Ss, Ss, Gs^Fp, Ss, Ww, Ww, Ss, Gs^Fp, Gs^Fp, Ss, Ss, Gs^Fp, Gg, Gg, Gg, Gg, Ss, Gg, Ss, Gs^Fp, Gs^Fp, Gs^Fp, Gs^Fp, Gs^Fp, Ss, Ss, Ss, Gs^Fp, Gs^Fp, Gs^Fp, Ss
Gg, Gs^Fp, Gs^Fp, Gs^Fp, Ss, Ss, Ww, Ww, Ww, Ww, Ww, Ss, Ss, Gs^Fp, Ss, Gs^Fp, Gg, Gg, Gg, Ss, Ss, Ss, Ss, Ss, Gg, Ss, Gg, Ss, Ss, Ss, Ss, Gs^Fp, Gs^Fp, Ss, Ss
