Mm, Mm, Mm^Xm, Hh, Mm, Hh, Hh, Hh, Mm, Mm, Mm^Xm, Mm, Mm, Gg, Gs^Fp, Gg, Hh, Gg, Gs^Fp, Gg, Gs^Fp, Gg, Mm, Mm, Mm^Xm, Mm, Mm, Hh, Hh, Hh, Mm^Xm, Mm, Mm, Mm, Hh
Mm, Mm, Mm^Xm, Mm^Xm, Mm, Mm, Hh, Hh, Hh, Mm, Mm, Mm^Xm, Mm^Xm, Mm, Mm, Gs^Fp, Gg, Gg, Gg, Hh, Mm, Mm, Mm^Xm, Mm^Xm, Mm, Mm, Hh, Hh, Mm, Mm^Xm, Mm^Xm, Mm^Xm, Mm^Xm, Mm, Mm^Xm
Mm^Xm, Mm^Xm, Mm, Mm, Hh, Hh, Hh, Hh^Es, Hh, Hh, Hh, Mm, Mm, Mm^Xm, Mm^Xm, Hh^Em, Chr, Gg^Es, Chr, Gg, Mm^Xm, Mm^Xm, Mm, Mm, Hh, Hh, Hh^Es, Mm, Mm, Mm, Mm, Mm^Xm, Mm, Mm^Xm, Hh
Mm, Mm, Hh^Es, Hh, Hh, Hh, Gg, Hh, Gg, Gg, Hh, Gg, Hh, Mm, Hh, Chr, Gg^Es, Chr, Gg^Es, Chr, Hh, Mm, Hh, Hh, Hh, Hh, Hh, Mm, Hh, Hh, Hh, Hh, Hh, Hh^Es, Gg
Hh^Fp, Mm, Hh, Hh, Hh, Gg, Gg, Gg, Gs^Fp, Gg, Gg, Gg, Gg, Hh, Gg, Chr^Es, Gg, Chr, Gg, Chr^Es, Gg, Hh, Gg, Hh, Hh, Hh^Em, Hh, Hh, Hh, Hh, Hh^Em, Hh, Hh, Hh, Gg
Hh^Fp, Hh^Fp, Hh^Fp, Hh, Hh, Gg, Gg, Gs^Fp, Hh^Em, Gs^Fms, Gs^Fms, Gg, Gg, Gg, Gg, Gg, Gg, Gg, Gg, Gg, Gg, Gg, Gs^Fp, Gg, Gg, Hh, Hh^Es, Hh, Hh, Hh, Hh, Hh, Gg, Gg, Gg
Hh, Hh^Fp, Hh^Es, Hh, Gg, Hh, Gg, Gg, Hh, Hh^Fms, Gs^Fp, Gg, Gg, Gg, Gg^Efm, Gg, Gg, Gg, Gg, Gg, Gs^Fp, Gs^Fp, Hh^Em, Gs^Fp, Gg, Hh, Hh, Hh, Hh^Em, Hh, Gg, Gg, Gg, Gs^Fp, Gg
Hh, Hh, Hh, Hh, Gg, Gg, Gg^Efm, Hh, Gg, Gg, Gg, Gg, Gg, Gg^Vc, Gg, Gg, Gg, Gg, Gg, Gg, Gg, Gs^Fp, Gg^Vc, Hh, Gs^Fp, Gg, Gg, Hh, Hh, Hh, Gg, Gg, Gs^Fp, Gs^Fp, Gg
Hh, Hh, Hh, Gg, Gs^Fp, Gs^Fp, Gg, Gs^Fp, Gs^Fms, Gg, Gg, Gg, Gg, Gg, Gg, Gg, Gg, Gg, Ww, Gg, Gg, Gg, Gg, Gg, Gs^Fp, Gg, Gg, Hh, Gg, Hh, Gg, Gg, Gs^Fp, Gs^Fp, Gs^Fp
Hh, Hh, Gg, Gg, Gg, Gs^Fp, Gg, Gg, Gg, Gg, Gg, Gg, Gg, Ww^Ewf, Ww, Ww, Ww, Ww, Ww, Ww, Gg, Gg, Gg, Gg, Gg, Gs^Fp, Gg, Gg, Gg, Gg, Gg, Gg, Gg, Gs^Fp, Gs^Fp
Gg, Gg, Gg, Gg, Gg, Gg, Gg^Vc, Gg, Gg, Gg, Gg, Gg, Ww, Ww, Ww, Ww, Ww, Ww, Wo, Ww, Ww, Ww, Ww, Ww, Ww, Gg, Gg, Gg, Gg^Vc, Gg, Gg, Gg, Gg, Gg, Gg
Gg, Gg, Ce, Gg, Gg, Gg, Gg, Gg, Gg, Gs^Fp, Gs^Fp, Ww, Ww, Ww, Ww, Ww, Wo, Wo, Wo, Wo, Wo, Ww, Ww, Ww, Ww^Ewf, Gg, Gg, Gg, Gg, Gg, Gg, Gg, Ce, Gg, Gg
Gg, Re^Gvs, 1 Ke, Ce, Gg, Gg, Gg, Gg, Hh, Hh^Em, Gg^Efm, Ww, Ww, Wo, Wo, Wo, Wo, Wo, Wo, Wo, Ww, Ww, Ww, Ww, Ww, Gs^Fds, Gg, Gg, Gg, Gg, Gg, Ce, 2 Ke, Re^Gvs, Gg
Gg, Gg, Ce, Ce, Gg, Gg, Ww, Gg, Gs^Fp, Gs^Fp, Ww^Ewl, Ww, Ww, Wo, Wo, Wo, Wo, Wo, Ww, Ww, Gg, Ww, Gg, Ww, Gg, Gg, Gg, Gg, Gg, Gg, Gg, Ce, Ce, Gg, Gg
Gg, Gg, Gg, Gg, Gg, Ww, Ww, Ww, Ww, Gg, Gg, Ww, Ww, Ww, Wo, Wo, Ww, Ww, Ww, Gg, Gs^Fp, Gg, Gs^Fp, Gg, Gg, Gg, Gg, Gs^Fp, Gs^Fms, Gg, Gg, Gg, Gg, Gg, Gg
Gg, Gg, Gg, Gg, Gg, Wwr, Ww, Ww, Ww, Gg, Gg^Vc, Gs^Fp, Ds, Ww, Ww, Ww, Gg, Ww, Gg, Gg, Gg, Gs^Fp, Gg, Gg^Vc, Gg, Gg, Gg, Gs^Fp, Gg^Efm, Gs^Fp, Gg, Gg, Gs^Fms, Ss, Gs^Fp
Gg, Gg, Gg, Gg, Gg, Wwf, Wwf^Ewf, Ww, Gg, Gg, Gg, Gg, Gg, Ww, Ww, Ww, Gg, Gs^Fms, Gs^Fp, Gg, Gg, Gg, Gg, Gg, Hh, Hh, Hh, Gg, Gg, Gg, Gg, Gg, Ss, Ss, Gs^Fp
Gs^Fp, Gs^Fp, Gg, Gg, Gg, Hh, Gs^Fms, Gg, Gg, Gs^Fp, Gg, Gg, Wwr, Ww^Bw\, Rd, Gg, Gg, Gs^Fp, Gg, Gg, Gg, Hh, Hh, Hh, Hh, Hh^Es, Mm, Hh, Hh, Gg, Gg, Gg, Gs^Fms, Ss, Gs^Fp
Gs^Fms, Gs^Fp, Gg, Rd^Vc, Gg, Gg, Gg, Gg, Gg, Gs^Fp, Gs^Fp, Gs^Fp, Ww, Ww, Gg, Rd, Rd, Gg, Gg, Gg, Gg, Hh, Hh, Mm, Hh^Em, Mm, Mm, Mm, Hh, Gg, Gg, Gg^Vc, Gg, Ss, Gs^Fp
Gs^Fp, Gs^Fp, Gg, Gg, Gg, Gg, Gg, Gg, Hh, Hh, Ds, Ww, Ww, Ss, Gg, Gg, Gg, Rd, Rd, Gg, Gg, Gg^Efm, Hh, Hh, Hh, Mm, Hh, Hh, Gg, Gg, Gg, Gg, Gs^Fp, Gg, Gs^Fp
Gg, Gg, Gg, Gg, Gg, Gg, Gg, Gg^Efm, Mm, Gs^Fp, Ss, Ww, Ww, Ds, Hh, Gg, Gs^Fp, Gg, Gg, Rd, Gg, Gg, Gg, Hh^Vhh, Hh, Hh, Hh, Hh, Gg, Gg, Gs^Fp, Gg^Efm, Gs^Fp, Ss, Ss
Hh, Hh, Hh, Gg, Gg, Gg, Gs^Fms, Hh, Hh, Hh^Em, Ss, Ww, Gg^Vh, Hh, Mm, Gg, Gs^Fp, Gs^Fms, Gg, Rd, Gg, Gg, Gg, Gg, Gg, Gg, Gg, Gg, Gg, Gg, Hh, Hh^Em, Gs^Fp, Ss, Ss
Hh, Hh^Es, Hh, Gg, Gg, Hh, Gs^Fp, Gs^Fp, Ds, Ss, Ww, Ww, Gg, Gs^Fp, Gs^Fp, Hh^Em, Gg, Gs^Fp, Gg, Rd, Gg, Hh, Hh, Gg, Gg, Gg, Ds, Gg, Gg^Vh, Gg, Gg, Gg, Gs^Fp, Ss, Gg
Hh, Mm, Mm, Hh, Gg, Gg, Gg, Gg, Gg, Ss, Ww, Ss, Gg, Gg, Gg, Gg, Gg, Gg, Gg^Efm, Gg, Gg, Gs^Fp, Wwr, Ds, Ww, Ww, Ww, Gg, Gs^Fp, Gs^Fp, Gs^Fp, Gg, Ss^Bw\, Ss, Gg
Hh, Hh^Es, Hh, Hh, Gg^Vh, Gg, Gg, Gg, Gg, Ss, Ww, Ss, Ss, Gg, Gg, Gg, Gs^Fp, Gg, Gg, Gg, Ds, Ww, Ww, Ww, Ww, Ww, Ww, Gs^Fp, Ss, Ss^Fmw, Ss, Ss, Ss, Gg, Gg
Hh, Hh, Gg, Gg, Gg, Gg, Gg, Gg, Gg, Gg, Ww, Ww^Ewf, Gg, Gg, Gg, Gs^Fp, Hh^Em, Gs^Fp, Hh, Gg, Gg, Ww, Ww, Ww, Ww, Ww, Ww^Ewf, Ss, Ss, Ss, Ss, Ss, Gs^Fp, Gs^Fp, Gs^Fp
Gg, Gg, Gg, Gg, Gg, Gs^Fp, Gs^Fp, Gg, Gs^Fp, Gg, Ww, Ww, Ww, Gg, Gg^Vh, Gg, Gg, Mm, Gg, Gg, Gg, Gg, Gg, Ww, Gs^Fp, Ww, Gs^Fp, Gs^Fp, Ss^Fmw, Ss, Ss^Fdw, Ss, Ss^Vhs, Gs^Fp, Gs^Fp
Gs^Fp, Gg, Gg, Gg, Gg, Gs^Fp, Gs^Fms, Hh^Em, Hh, Gs^Fms, Ds, Ww, Ww, Gg, Gg, Gg, Gg, Hh, Gg, Rd, Gg^Vh, Gs^Fp, Gs^Fp, Gs^Fms, Gs^Fp, Ds, Gg^Efm, Gs^Fp, Gs^Fp, Ss, Ss^Fmw, Ss, Gs^Fp, Gg, Gg
Gg, Gs^Fp, Gs^Fp, Gg, Gs^Fp, Gs^Fp, Hh^Fms, Hh, Hh, Gg, Ds, Ww, Ww^Ewl, Gg, Gg^Efm, Gg^Efm, Gg, Gg, Rd, Rd, Gs^Fp, Gs^Fp, Hh, Hh, Hh, Gs^Fp, Hh, Gg^Vh, Gs^Fp, Ss, Ss^Fdw, Ss^Fdw, Ss, Ss, Gs^Fp
Ss, Gs^Fp, Gs^Fp, Gg^Efm, Gs^Fp, Gg, Hh^Es, Hh, Gg, Gg, Ww, Ww, Ss, Gg, Gg, Gg^Efm, Gg, Gg, Co, Co, Co, Gs^Fms, Gs^Fp, Mm, Mm, Hh, Hh, Gs^Fp, Ss^Fmw, Ss, Ss, Gs^Fp, Gs^Fp, Ss, Ss
Gs^Fp, Ss, Ss, Gs^Fp, Gs^Fp, Gg, Hh, Hh^Fms, Gs^Fp, Gs^Fp, Ww, Ww, Ss, Ss, Gg, Gg, Gg, Co, Co, Co, Co, Co, Gg, Hh^Em, Hh, Mm, Hh, Gs^Fp, Ss, Ss, Ss^Fdw, Ss, Gs^Fp, Gs^Fp, Ss
Ss, Ss, Ss, Gg, Gg, Hh^Em, Gg, Gg, Gs^Fp, Ds, Ww, Ww, Gs^Fms, Ss, Gs^Fp, Gg, Gg, Gg, Gg, Ko, Gg, Gg, Gs^Fp, Gs^Fms, Ss, Gs^Fp, Ss, Gs^Fp, Ss, Ss, Ss, Ss, Ss, Gs^Fp, Ss
Ss, Gg, Ss^Vhs, Ss, Ss, Gs^Fp, Ss, Gs^Fp, Ww^Ewf, Ww, Ww, Ss, Gs^Fp, Gs^Fp, Gs^Fms, Gg, Gg, Gg, Gg, Gg, Gg^Vh, Gg, Ss, Ss, Gs^Fp, Ss, Gs^Fp, Ss, Ss, Ss^Fdw, Ss, Gs^Fp, Gs^Fp, Gs^Fp, Gs^Fp
Gg, Gg, Gs^Fp, Ss, Ss, Ss, Ds, Ss, Ww, Ww, Ss, Ds, Gs^Fp, Ss, Ss, Gs^Fp, Gg, Gg, Gg, Gg, Ss, Gg, Ss, Gs^Fp, Gs^Fp, Gs^Fp, Gs^Fp, Gs^Fp, Ss, Ss, Ss, Gs^Fp, Gs^Fp, Gs^Fp, Ss
Gg, Gs^Fp, Gs^Fp, Gs^Fp, Ss, Ss, Ww, Ww, Ww, Ww, Ww, Ss, Ss, Gs^Fp, Ss, Gs^Fp, Gg, Gg, Gg, Ss, Ss, Ss, Ss, Ss, Gg, Ss, Gg, Ss, Ss, Ss, Ss, Gs^Fp, Gs^Fp, Ss, Ss
