Hh, Hh, Hh, Hh, Hh, Mm, Mm, Hh, Mm, Mm, Mm, Mm^Xm, Mm^Xm, Mm^Xm, Xu, Xu, Xu, Mm^Xm, Mm^Xm, Mm^Xm, Mm, Mm, Mm, Mm, Mm, Hh, Hh, Hh, Hh, Mm, Hh
Hh, Hh, Hh, Mm, Mm, Mm, Mm, Mm, Mm, Mm, Mm^Xm, Mm^Xm, Mm^Xm, Mm^Xm, Xu, Qxu, Xu, Mm^Xm, Mm^Xm, Mm^Xm, Mm^Xm, Mm, Mm, Mm, Mm, Mm, Mm, Hh, Hh, Hh, Hh
Hh, Hh, Hh, Mm, Mm, Mm, Mm, Mm, Mm, Mm^Xm, Mm^Xm, Hh, Hh, Gs^Fp, Xu, Uu^Ii, Xu, Gs^Fp, Hh, Hh, Mm^Xm, Mm^Xm, Mm, Mm, Mm, Mm, Mm, Hh, Hh, Hh, Hh
Hh, Hh, Hh, Mm, Mm, Mm, Mm, Mm, Mm^Xm, Mm^Xm, Hh, Gg, Gg, Gg, Mm, Gg, Mm, Gg, Gg, Gg, Hh, Mm^Xm, Mm^Xm, Mm, Mm, Mm, Mm, Mm, Mm, Hh, Hh
Mm, Mm, Mm, Mm, Mm, Mm, Mm, Mm, Mm^Xm, Mm, Gg, Gg, Gg, Hh, Gs^Fp, Hh, Gs^Fp, Hh, Gg, Gg, Gg, Mm, Mm^Xm, Mm, Mm, Mm, Mm, Mm, Mm, Mm, Mm
Mm, Mm, Mm, Mm, Mm, Mm, Mm, Mm^Xm, Mm^Xm, Hh, Gg, Gg^Vc, Gg, Gg, Gg, Chs, Gg, Gg, Gg, Gg^Vc, Gg, Hh, Mm^Xm, Mm^Xm, Mm, Mm, Mm, Mm, Mm, Mm, Mm
Mm, Mm, Mm, Hh, Mm, Mm, Mm, Mm^Xm, Hh, Gg, Gg, Gg, Gs^Fp, Gg, Gg, Gg, Gg, Gg, Gs^Fp, Gg, Gg, Gg, Hh, Mm^Xm, Mm, Mm, Mm, Mm, Mm, Mm, Mm
Mm, Mm, Hh, Hh, Mm, Mm, Mm^Xm, Mm^Xm, Gg, Gg, Gs^Fp, Hh, Mm, Hh, Chs, Gg, Chs, Hh, Mm, Hh, Gs^Fp, Gg, Gg, Mm^Xm, Mm^Xm, Mm, Mm, Hh, Hh, Hh, Mm
Mm, Mm, Hh, Mm, Mm, Mm, Mm^Xm, Gg, Gg, Hh, Mm, Hh, Gg, Gs^Fp, Gg, Gg, Gg, Gs^Fp, Gg, Hh, Mm, Hh, Gg, Gg, Mm^Xm, Mm, Mm, Mm, Hh, Hh, Mm
Mm, Mm, Mm, Mm, Mm, Mm, Mm^Xm, Hh, Gg, Gs^Fp, Hh, Gg, Gg, Gg, Gg, Ss, Gg, Gg, Gg, Gg, Hh, Gs^Fp, Gg, Hh, Mm^Xm, Mm, Mm, Mm, Mm, Hh, Mm
Mm, Mm, Mm, Mm, Mm, Mm, Mm^Xm, Hh, Gg, Gg, Gg, Gg, Ss^Vhs, Gg, Ss, Gs^Fp, Ss, Gg, Ss^Vhs, Gg, Gg, Gg, Gg, Hh, Mm^Xm, Mm, Mm, Mm, Mm, Hh, Mm
Mm, Mm, Mm, Mm, Mm, Mm^Xm, Mm^Xm, Hh, Chr, Gg, Gs^Fp, Gg, Gg, Hh, Gs^Fp, Hh, Gs^Fp, Hh, Gg, Gg, Gs^Fp, Gg, Chr, Hh, Mm^Xm, Mm^Xm, Mm, Mm, Mm, Mm, Mm
Mm, Mm, Mm, Mm^Xm, Mm^Xm, Mm^Xm, Gg, Chr, Khr, Gg, Gg, Gg, Gg, Gg, Ss, Hh, Ss, Gg, Gg, Gg, Gg, Gg, Khr, Chr, Gg, Mm^Xm, Mm^Xm, Mm^Xm, Mm, Mm, Mm
Mm, Mm, Mm, Mm^Xm, Ww, Mm^Xm, Gg, Chr, Gg, Hh, Gg, Gg, Gs^Fp, Wwf, Wwf, Hh, Wwf, Wwf, Gs^Fp, Gg, Gg, Hh, Gg, Chr, Gg, Mm^Xm, Ww, Mm^Xm, Mm, Mm, Mm
Mm, Mm, Mm, Mm^Xm, Mm^Xm, Ww, Ww, Ww^Bw|, Ww, Gs^Fp, Gg, Gg, Gg^Vc, Gg, Wwf, Ww, Wwf, Gg, Gg^Vc, Gg, Gg, Gs^Fp, Ww, Ww^Bw|, Ww, Ww, Mm^Xm, Mm^Xm, Mm, Mm, Mm
Mm, Mm, Mm, Mm, Mm, Mm^Xm, Gg, Gg, Gg, Ww, Ww, Gg, Hh, Gg, Ww, Ww, Ww, Gg, Hh, Gg, Ww, Ww, Gg, Gg, Gg, Mm^Xm, Mm, Mm, Mm, Mm, Mm
Mm, Mm, Mm, Mm, Mm^Xm, Mm^Xm, Gg, 1 Khr, Chr, Gg, Gg, Ww, Ww, Ww, Ww, Wwf, Ww, Ww, Ww, Ww, Gg, Gg, Chr, 2 Khr, Gg, Mm^Xm, Mm^Xm, Mm, Mm, Mm, Mm
Mm, Mm, Mm, Mm, Mm^Xm, Gg, Gg, Chr, Gg, Gg, Gg, Gs^Fp, Ww, Ww, Ww, Gs^Fp, Ww, Ww, Ww, Gs^Fp, Gg, Gg, Gg, Chr, Gg, Gg, Mm^Xm, Mm, Mm, Mm, Mm
Mm, Mm, Mm, Mm, Mm^Xm, Gg, Gg, Chr, Gg, Gg, Hh, Ss, Ww, Ww, Hh, Wwf, Hh, Ww, Ww, Ss, Hh, Gg, Gg, Chr, Gg, Gg, Mm^Xm, Mm, Mm, Mm, Mm
Mm, Mm, Mm, Mm, Mm^Xm, Hh, Gg, Gg, Gs^Fp, Gg, Gg, Gs^Fp, Ss, Ww, Ww, Ww, Ww, Ww, Ss, Gs^Fp, Gg, Gg, Gs^Fp, Gg, Gg, Hh, Mm^Xm, Mm, Mm, Mm, Mm
Mm, Mm, Mm, Mm, Mm^Xm, Mm^Xm, Hh, Hh, Ss^Vhs, Ss, Gg, Gg, Gg, Gg^Vh, Hh, Gs^Fp, Hh, Gg^Vh, Gg, Gg, Gg, Ss, Ss^Vhs, Hh, Hh, Mm^Xm, Mm^Xm, Mm, Mm, Mm, Mm
Mm, Mm, Mm, Mm, Mm, Mm^Xm, Mm^Xm, Gg, Hh, Gg, Gs^Fp, Hh, Gs^Fp, Gg, Gg, Chs, Gg, Gg, Gs^Fp, Hh, Gs^Fp, Gg, Hh, Gg, Mm^Xm, Mm^Xm, Mm, Mm, Mm, Mm, Mm
Hh, Hh, Hh, Mm, Mm, Mm, Mm^Xm, Mm^Xm, Mm^Xm, Hh, Hh, Mm, Hh, Gg, Gg, Gg, Gg, Gg, Hh, Mm, Hh, Hh, Mm^Xm, Mm^Xm, Mm^Xm, Mm, Mm, Mm, Mm, Mm, Hh
Hh, Hh, Hh, Mm, Mm, Mm, Mm, Mm, Mm^Xm, Mm^Xm, Mm^Xm, Hh, Gg, Gg, Chr, Gg, Chr, Gg, Gg, Hh, Mm^Xm, Mm^Xm, Mm^Xm, Mm, Mm, Mm, Mm, Mm, Mm, Mm, Hh
Hh, Hh, Hh, Hh, Mm, Mm, Mm, Mm, Mm, Mm, Mm^Xm, Mm^Xm, Mm^Xm, Chr, Gg, Chr, Gg, Chr, Mm^Xm, Mm^Xm, Mm^Xm, Mm, Mm, Mm, Mm, Mm, Mm, Mm, Mm, Hh, Hh
Hh, Hh, Hh, Hh, Hh, Mm, Mm, Mm, Mm, Mm, Mm, Mm, Mm^Xm, Chr, Gg, Chr, Gg, Chr, Mm^Xm, Mm, Mm, Mm, Mm, Mm, Mm, Hh, Hh, Hh, Hh, Hh, Hh
Hh, Hh, Hh, Hh, Hh, Hh, Hh, Hh, Hh, Hh, Hh, Hh, Hh, Gg, Gg, Gg, Gg, Gg, Hh, Hh, Hh, Hh, Hh, Mm, Hh, Mm, Mm, Mm, Hh, Mm, Hh
