Xu, Xu, Xu, Xu, Xu, Xu, Xu, Xu, Xu, Xu, Xu, Wog, Wog, Wog, Xu, Xu, Xu, Xu, Xu, Xu, Xu, Xu, Xu, Xu, Xu, Xu, Xu, Xu, Xu, Xu, Xu, Xu, Xu, Xu, Xu
Xu, Xu, Xu, Xu, Xu, Xu, Xu, Xu, Xu, Xu, Wog, Wog, Wog, Wog, Xu, Xu, Xu, Xu, Xu, Xu, Xu, Xu, Xu, Xu, Xu, Xu, Xu, Xu, Xu, Xu, Xu, Xu, Xu, Xu, Xu
Xu, Xu, Xu, Xu, Xu, Xu, Xu, Xu, Xu, Xu, Wog, Wog, Xu, Xu, Xu, Xu, Xu, Xu, Xu, Xu, Xu, Xu, Xu, Xu, Xu, Xu, Xu, Xu, Uu, Uu, Uu, Xu, Xu, Xu, Xu
Xu, Xu, Xu, Xu, Xu, Xu, Xu, Xu, Xu, Xu, Wog, Wog, Xu, Xu, Xu, Xu, Xu, Xu, Xu, Xu, Xu, Xu, Xu, Xu, Xu, Xu, Xu, Uu, Uu, Uu, Uu, Xu, Xu, Xu, Xu
Xu, Xu, Xu, Xu, Xu, Xu, Xu, Xu, Xu, Xu, Wog, Wog, Xu, Xu, Xu, Xu, Cud, 5 Kud, Cud, Xu, Xu, Xu, Xu, Xu, Xu, Xu, Xu, Uh, Re, Re, Re, Uu, Xu, Xu, Xu
Xu, Xu, Xu, Xu, Rr, Rr, Rr, Xu, Wog, Wog, Wog, Xu, Xu, Xu, Xu, Cud, Uu, Cud, Uu, Cud, Xu, Xu, Xu, Xu, Xu, Xu, Xu, Xu, Re, Re, Uu, Uh, Xu, Xu, Xu
Xu, Xu, Xu, Xu, Rr, Rr, Cud, Xu, Wog, Wog, Xu, Xu, Xu, Xu, Uh, Cud, Cud, Cud, Cud, Cud, Uu, Xu, Xu, Xu, Xu, Xu, Xu, Xu, Uu, Re, Uu, Xu, Uu^Ii, Xu, Xu
Xu, Xu, Xu, Xu, Cud, Cud, Wog, Wog, Xu, Wog, Xu, Xu, Xu, Uu, Xu, Cud, Cud, Uu, Cud, Cud, Xu, Uu, Xu, Xu, Xu, Xu, Xu, Uu^Tf, Uh, Uu, Uu, Uh, Uu^Tf, Xu, Xu
Xu, Xu, Xu, Xu, Wog, Wog^Bw|, Cud, Xu, Xu, Xu, Uu^Vud, Xu, Xu, Uh, Xu, Xu, Xu, Uu, Xu, Xu, Xu, Uh, Xu, Xu, Xu, Xu, Xu, Uu^Tf, Uu, Uu, Re, Uu, Xu, Xu, Xu
Qxu, Wog, Wog, Wog, Wwg, Cud, Rr, Xu, Xu, Xu, Uu^Tf, Uu, Uh, Uu^Tf, Uu^Tf, Xu, Uu, Uu, Uu, Xu, Uu, Uu^Tf, Uu^Tf, Uu^Vud, Uu^Tf, Xu, Xu, Xu, Uu, Re, Re, Uh, Uu^Vud, Xu, Xu
Qxu, Wog, Xu, Xu, Wwg, Wwg, Wwg, Xu, Xu, Uu^Tf, Uu, Uh, Uu^Vud, Uu, Uh, Uu, Rr, Rr, Rr, Uu, Uu^Tf, Uu, Uh, Uu, Uu^Vu, Uh, Xu, Xu, Uh, Ur, Uu^Tfi, Uu, Uh, Xu, Xu
Qxu, Qxu, Xu, Xu, Wwf, Wwg, Wwf, Xu, Xu, Uu^Vud, Uu, Uu, Uu, Uu, Uu^Tf, Uu, Rr, Qxe^Ii, Rr, Uu, Uu^Vud, Uu, Uu, Uu, Uh, Xu, Uu^Ii, Xu, Uu^Tf, Uu, Ur, Uu, Xu, Xu, Xu
Xu, Xu, Xu, Xu, Wwg^Tf, Wwg, Wwf, Xu, Xu, Xu, Uu^Vud, Uh, Uu^Tf, Uu, Uu, Uu, Uu, Rr, Uu, Uu, Uu, Uu, Uu, Uu^Tf, Xu, Xu, Xu, Uu^Tf, Re, Re, Re, Uu, Uu^Tf, Xu, Xu
Xu, Uu^Vud, Xu, Xu, Wwg, Wwg, Wwf, Xu, Xu, Xu, Xu, Xu, Xu, Uu^Vud, Xu, Xu, Uu, Xos, Uu, Xu, Xu, Uu^Tf, Xu, Uu^Vud, Xu, Xu, Xu, Xu, Uh, Re, Uu, Uh, Xu, Xu, Xu
Xu, Uu^Tfi, Uu, Cud, Wwg, Wwf, Wwf, Cud, Rr, Uu^Tf, Uh, Xu, Xu, Xu, Xu, Xu, Rr, Rr, Rr, Xu, Xu, Xu, Xu, Xu, Uh, Uu^Tf, Rr, Cud, Re, Ur, Uu, Uu^Tf, Xu, Xu, Xu
Xu, Uu, Uu^Tf, Re^Tf, Wwf, Wwf, Wwf, Rr, Uu^Tf, Uu^Vud, Uu, Xu, Qxu, Qxu, Rr, Rr, Cud, Cud, Cud, Rr, Rr, Qxu, Qxu, Xu, Uu, Uu^Vud, Rr, Rr, Re, Uu, Uh, Xu, Xu, Xu, Xu
Xu, Uu^Vud, Xu, Cud, Uu^Tfi, Wwf, Wwf, Cud, Xu, Rr, Qxu^Bs|, Xu, Qxu, Ur, Rr, Cud, Cud, Kud, Cud, Cud, Rr, Ur, Qxu, Xu, Qxu^Bs|, Uh, Xu, Cud, Uu^Tf, Uu, Re, Uu, Uu^Tf, Xu, Xu
Xu, Xu, Xu, Xu, Rr, Wwg, Wwg, Xu, Xu, Qxu, Uu, Xu, Uu^Vud, Qxu^Bs|, Xu, Rr, Rr, Cud, Rr, Rr, Xu, Qxu^Bs|, Uu^Vud, Xu, Uu, Qxu, Xu, Xu, Uh, Re, Uu^Tf, Xu, Uh, Uu^Vud, Xu
Xu, Xu, Uu^Tf, Wwf, Rr, Wwg, Wwg, Re^Tf, Xu, Qxu, Cud, Uu, Uu, Uu, Xu, Xu, Rr, Rr, Rr, Xu, Xu, Uu, Uu, Uu, Cud, Qxu, Xu, Xu, Uu^Tf, Uu, Re, Xu, Xu, Uu, Xu
Xu, Xu, Uu, Wwf, Wwf, Rr, Re^Tf, Wwf, Xu, Qxu, Cud, 3 Kud, Cud, Uu, Xu, Xu, Cud, 1 Rr, Cud, Xu, Xu, Uu, Cud, 4 Kud, Cud, Qxu, Xu, Uu^Vud, Uu, Ur, Uh, Xu, Uh, Uu^Tfi, Xu
Xu, Uu^Vud, Uu, Wwf, Wwf, Rr, Wwf, Wwf, Xu, Qxu, Qxu, Cud, Qxu, Qxu, Xu, Qxu, Qxu, Rr, Qxu, Qxu, Xu, Qxu, Qxu, Cud, Qxu, Qxu, Xu, Uu^Tf, Uu, Re, Uu, Xu, Uu^Tf, Xu, Xu
Xu, Uh, Uu, Uu, Re^Tf, Rr, Rr, Xu, Xu, Xu, Xu, Qxu, Xu, Xu, Qxu, Qxu, Qxu, Qxu^Bs|, Qxu, Xu, Xu, Xu, Qxu, Qxu, Xu, Xu, Xu, Xu, Re, Re, Uu^Tf, Re, Uu, Xu, Xu
Xu, Xu, Uu^Vud, Uu^Tf, Rr, Rr, Rr, Xu, Rr, Xu, Xu, Xu, Xu, Xu, Qxu, Qxu, Cud, Rr, Cud, Qxu, Qxu, Xu, Xu, Xu, Xu, Uu^Tf, Uu, Uu^Tf, Re, Uu, Uu^Tf, Uu, Xu, Xu, Xu
Xu, Xu, Xu, Xu, Xu, Rr, Rr, Rr, Rr, Rr, Rr, Xu, Xu, Xu, Xu, Xu, Rr, Rr, Rr, Xu, Xu, Xu, Xu, Xu, Uu, Uh, Re, Re, Re, Uu, Xu, Xu, Xu, Xu, Xu
Xu, Xu, Xu, Xu, Xu, Rr, Rr, Rr, Rr, Rr, Rr, Rr, Rr, Xu, Xu, Xu, Rr, Rr, Rr, Xu, Xu, Xu, Uu, Uu^Tf, Uu, Re, Re, Uu^Ii, Xu, Re, Re, Uu^Tf, Xu, Xu, Xu
Xu, Xu, Xu, Xu, Uh, Rr, Xu, Xu, Xu, Rr, Rr, Rr, Rr, Cud, Rr, Cud, Rr, Rr, Rr, Cud, Uu, Uu, Re, Ur, Uh, Uu, Uu^Tf, Xu, Uh, Re, Rr, Uh, Xu, Xu, Xu
Xu, Xu, Uu^Tf, Uu^Vud, Uu, Ur, Uh, Xu, Xu, Xu, Rr, Rr, Rr, Rr, Rr, Rr, Rr, Rr, Rr, Rr, Ur, Re, Uu^Tf, Uu, Xu, Uu^Vud, Xu, Xu, Xu, Uh, Rr, Uu, Uu^Vud, Xu, Xu
Xu, Xu, Uu, Uh, Uu^Tf, Ur, Uu^Vud, Uu^Tf, Ur, Rr, Xu, Xu, Xu, Cud, Xu, Cud, Rr, Rr, Rr, Cud, Xu, Uh, Xu, Xu, Xu, Xu, Xu, Xu, Uu^Vud, Uu^Tf, Rr, Uu, Uu^Tf, Xu, Xu
Xu, Xu, Uu^Vud, Uu, Uh, Ur, Ur, Uh, Uu, Uu, Uu^Tf, Xu, Xu, Xu, Xu, Xu, Cud, Rr, Cud, Xu, Xu, Xu, Xu, Xu, Xu, Xu, Xu, Xu, Uh, Uu, Rr^Dr, Uu, Xu, Xu, Xu
Xu, Xu, Cud, Uu^Tf, Cud, Uu, Uu^Tf, Uu, Uu^Vud, Uu, Uu, Uu^Vud, Xu, Xu, Cud, Cud, Kud, Rr, Kud, Cud, Cud, Xu, Xu, Xu, Xu, Xu, Xu, Xu, Xu, Uu, Rr, Uu^Tf, Cud, Xu, Xu
Xu, Xu, Xu, Cud, 6 Kud, Cud, Uu, Uu, Uu^Tf, Uu, Uh, Xu, Xu, Xu, Xu, Cud, Rr, Rr, Rr, Cud, Xu, Xu, Xu, Xu, Xu, Xu, Xu, Uh, Uu, Uu^Tf, Uu, Uu, Cud, Xu, Xu
Xu, Xu, Xu, Cud, Xu, Cud, Uu^Vud, Uh, Xu, Uu^Vud, Xu, Xu, Xu, Xu, Xu, Xu, Uu^Ii, Rr, Uu^Ii, Xu, Xu, Xu, Xu, Xu, Xu, Xu, Xu, Uu^Vud, Uu^Tf, Uu, Cud, 7 Kud, Cud, Xu, Xu
Xu, Xu, Xu, Xu, Xu, Xu, Xu, Xu, Xu, Xu, Xu, Xu, Xu, Xu, Xu, Xu, Uu^Ii, 2 Uu^Ii, Uu^Ii, Xu, Xu, Xu, Xu, Xu, Xu, Xu, Xu, Xu, Uh, Uh, Cud, Cud, Xu, Xu, Xu
Xu, Xu, Xu, Xu, Xu, Xu, Xu, Xu, Xu, Xu, Xu, Xu, Xu, Xu, Xu, Xu, Xu, Uu^Ii, Xu, Xu, Xu, Xu, Xu, Xu, Xu, Xu, Xu, Xu, Xu, Xu, Xu, Xu, Xu, Xu, Xu
Xu, Xu, Xu, Xu, Xu, Xu, Xu, Xu, Xu, Xu, Xu, Xu, Xu, Xu, Xu, Xu, Xu, Xu, Xu, Xu, Xu, Xu, Xu, Xu, Xu, Xu, Xu, Xu, Xu, Xu, Xu, Xu, Xu, Xu, Xu
