Xu, Xu, Xu, Xu, Xu, Xu, Xu, Xu, Rr, Rr, Rr, Xoa, Xu, Xu, Xu, Xu, Xu, Xu, Xu, Xu, Xu, Xu, Xu, Xu, Xu, Xu, Xu, Xu, Xu, Xu, Xu, Xu, Xu, Xu, Xu, Xu, Xu
Xu, Xu, Xu, Xu, Xu, Xu, Xu, Xoa, Rr, Rr, Rr, Xoa, Xu, Xu, Xu, Xu, Xu, Uu, Uu, Uu, Xu, Xu, Xu, Xu, Xu, Xu, Xu, Uh, Uh, Xu, Xu, Xu, Xu, Xu, Xu, Xu, Xu
Xu, Xu, Re, Xu, Xu, Xu, Xu, Xoa, Rr, Rr, Rr, Xoa, Xu, Xu, Xu, Xu, Xu, Xoa, Cud, Xoa, Xu, Xu, Xu, Xu, Xu, Xu, Rr, Xu, Uh, Xu, Xu, Xu, Xu, Xu, Re, Xu, Xu
Xu, Xu, Xu, Xu, Xu, Xu, Xu, Xoa, Rr, Rr, Rr, Xoa, Xu, Xu, Xu, Xu, Cud, Cud, Rr, Cud, Cud, Xu, Xu, Xu, Xu, Xu, Uh, Rr, Uh, Xu, Xu, Xu, Xu, Xu, Xu, Xu, Xu
Xu, Xu, Xu, Xu, Xu, Xu, Xu, Xoa, Rr, Rr, Rr, Xoa, Xoa, Xu, Xoa, Xu, Rr, Rr, Rr, Rr, Rr, Xu, Xoa, Xu, Xoa, Xu, Rr, Rr, Rr, Xu, Xu, Xu, Xu, Xu, Xu, Xu, Xu
Xu, Xu, Xu, Xu, Xu, Xu, Xu, Xoa, Cud, Cud, Cud, Xoa^Efs, Uu, Xu, Uu, Xoa, Cud, Rr, Rr, Rr, Cud, Xoa, Uu, Xu, Uu, Xoa^Efs, Cud, Cud, Cud, Xoa, Xu, Xu, Xu, Xu, Xu, Xu, Xu
Xu, Xu, Xu, Xu, Xu, Xu, Xoa, Cud, Cud, 4 Kud, Cud, Cud, Uu, Uu, Uu, Uu, Xoa, Rr, Rr, Rr, Xoa, Uu, Uu, Uu, Uu, Cud, Cud, 5 Kud, Cud, Cud, Xoa, Xu, Xu, Xu, Xu, Xu, Xu
Xu, Xu, Xu, Xu, Uu, Xu, Xu, Xoa, Xoa, Cud, Xoa, Xoa, Xu, Xu, Xu, Xu, Uh, Cud, Uu, Cud, Uh, Xu, Xu, Xu, Xu, Xoa, Xoa, Cud, Xoa, Xu, Xu, Xu, Uu, Xu, Xu, Xu, Xu
Xu, Xu, Xu, Uu, Uu, Uu, Xu, Xoa, Rr, Rr, Rr, Xu, Xoa, Xoa, Xu, Xoa, Uu, Uu, Rr, Uu, Uu, Xu, Xoa, Xu, Xoa, Xu, Rr, Rr, Rr, Xu, Xu, Uu, Uu, Uu, Xu, Xu, Xu
Xu, Xu, Xu, Xoa, Cud, Xoa, Xu, Xoa, Rr, Rr, Rr, Uu, Uh, Cud, Uu, Uh, Rr, Uu^Vud, Uu, Uu^Vud, Rr, Uh, Uu, Cud, Uh, Uu, Rr, Rr, Rr, Xu, Xoa, Xoa, Cud, Xoa, Xu, Xu, Xu
Xu, Xu, Xoa, Cud, Rr, Cud, Xoa, Xoa, Rr, Rr, Rr, Rr, Uu, Rr, Uu, Uu^Vud, Rr, Uu, Uh, Uu^Tf, Rr, Uu^Vud, Uu, Rr, Uu, Uu, Rr, Rr, Rr, Xu, Xoa, Cud, Rr, Cud, Xoa, Xu, Xu
Xu, Xu, Cud, Rr, Rr, Rr, Cud, Xoa, Rr, Rr, Rr, Uu, Xu, Cud, Xoa, Uu, Rr, Uu^Tf, Uu, Uu^Tf, Rr, Uu, Xoa, Cud, Xoa, Uu, Rr, Rr, Rr, Xoa, Cud, Rr, Rr, Rr, Cud, Xu, Xu
Xu, Xu, Rr, Rr, Uu^Vud, Rr, Rr, Uu, Rr, Rr, Rr, Xoa, Uu^Tf, Xu, Uu^Tf, Xu, Uu^Tf, Uu^Vud, Rr, Uu^Vud, Uh, Xu, Uu^Tf, Xu, Uh, Xoa, Rr, Rr, Rr, Uu, Rr, Rr, Uu^Vud, Rr, Rr, Xu, Xu
Xu, Xu, Cud, Rr, Rr, Rr, Cud, Uu, Rr, Rr, Rr, Uu, Uu, Uh, Uu^Vud, Xu, Xu, Uu, Uu, Uu, Xu, Xoa, Uu, Uu^Vud, Uu, Uu, Rr, Rr, Rr, Uu, Cud, Rr, Rr, Rr, Cud, Xu, Xu
Xu, Xu, Xu, Rr, Cud, Rr, Xu, Xoa, Rr, Rr, Rr, Uu, Uh, Uu, Uu, Uh, Xu, Uh, Uu, Uu, Xu, Uu^Tf, Uh, Uu, Uu, Uu^Tf, Rr, Rr, Rr, Xoa, Xoa, Rr, Cud, Rr, Xu, Xu, Xu
Xu, Xu, Xu, Xu, Xoa, Uu, Xu, Uu, Rr, Rr, Rr, Xu, Xu, Uu^Tf, Xu, Xu, Xoa^Efs, Xoa, Qxu^Bs|, Xoa, Xoa, Xu, Xu, Uu, Xu, Xu, Rr, Rr, Rr, Uu, Xu, Uu, Xoa, Xu, Xu, Xu, Xu
Xu, Xu, Xoa, Uh, Uu, Uu, Xu, Uu^Vud, Rr, Rr, Rr, Cud, Uu, Uh, Uu, Xoa, Cud, Qxu, Cud, Qxu, Cud, Xoa, Uh, Uu^Tf, Uu, Cud, Rr, Rr, Rr, Uu^Vud, Xu, Uu, Uu, Xu, Xu, Xu, Xu
Xu, Xu, Uu^Tf, Uu, Xu, Xu, Xu, Uu, Rr, Rr, Rr, Uu, Uu, Uu, Uu^Vud, Uu, Cud, Cud, 3 Kud, Cud, Cud, Uu, Uu^Vud, Uu, Uu, Uu, Rr, Rr, Rr, Uu, Xu, Uu^Tf, Uu, Uh, Xu, Xu, Xu
Xu, Xu, Uu, Uu, Uu, Xu, Xu, Xu, Rr, Rr, Rr, Uu, Uh, Uu, Uu, Uu, Cud, Cud, Cud, Cud, Cud, Uu, Uu, Uu, Uh, Uu, Rr, Rr, Rr, Xu, Uu^Tf, Xu, Xu, Uu, Uu^Tf, Xu, Xu
Xu, Xu, Xu, Uu^Vud, Rr, Uu, Uu, Uu, Rr, Rr, Rr, Cud, Xu, Uh, Xu, Xoa, Xoa, Qxu, Qxu^Bs|, Qxu, Xoa, Xoa, Xu, Uu, Xu, Cud, Rr, Rr, Rr, Uu, Uu, Xu, Rr, Uu, Xu, Xu, Xu
Xu, Xu, Uu^Tf, Rr, Rr, Rr, Uh, Uu, Rr, Rr, Rr, Xu, Uh, Uu^Tf, Uu, Xu, Xu, Xoa, Uu, Xoa, Xu, Xu, Uu, Uu^Tf, Xu, Xu, Rr, Rr, Rr, Uh, Uu, Rr, Rr, Rr, Uu, Xu, Xu
Xu, Xu, Uu, Rr, Rr, Rr, Uu, Xu, Rr, Rr, Rr, Uu, Uu, Uu, Uh, Xu, Xu, Uu, Qxu, Qxu, Xu, Uh, Uu^Vud, Uu, Uu, Uu, Rr, Rr, Rr, Xu, Xu, Rr, Rr, Rr, Uu^Tf, Uu^Tf, Xu
Xu, Xu, Xu, Uu^Vud, Uh, Uu^Tf, Uh, Xu, Rr, Rr, Rr, Uu, Uu^Tf, Uu^Vud, Xu, Xu, Uh, Uu, Qxu, Uu, Uu^Tf, Xu, Uu^Tf, Uu, Uh, Uu, Rr, Rr, Rr, Xu, Xu, Uu^Vud, Uh, Uu, Uu, Uu^Vud, Xu
Xu, Xu, Xu, Uu, Xu, Uu, Xu, Xu, Rr, Rr, Rr, Xu, Xu, Xu, Xu, Xu, Qxu, Uh, Qxu, Uu, Qxu, Xu, Xu, Xu, Xu, Xu, Rr, Rr, Rr, Xu, Xu, Xu, Xu, Uu, Xu, Uh, Xu
Xu, Xu, Rr, Rr, Rr, Xu, Cud, Cud, Rr, Rr, Rr, Rr, Uu, Cud, Uu, Uu^Tf, Uu, Qxu, Uu, Uu, Uu, Uu, Uh, Cud, Uu, Rr, Rr, Rr, Rr, Cud, Cud, Xu, Rr, Rr, Rr, Xu, Xu
Xu, Xu, Rr, Rr, Rr, Xu, Cud, Kud, Rr, Rr, Rr, Rr, Uu, Uu, Uh, Uu^Vud, Uu, Qxu, Uu, Qxu, Uu, Uu^Vud, Uu, Uu, Uh, Rr, Rr, Rr, Rr, Kud, Cud, Xu, Rr, Rr, Rr, Xu, Xu
Xu, Xu, Xu, Cud, Xu, Xu, Xu, Cud, Rr, Rr, Rr, Rr, Xu, Cud, Xu, Uu, Qxu, Qxu, Qxu, Qxu, Uu, Uh, Xu, Cud, Xu, Rr, Rr, Rr, Rr, Cud, Xu, Xu, Xu, Cud, Xu, Xu, Xu
Xu, Xu, Uu, Uu, Uu, Xu, Xu, Xu, Rr, Rr, Rr, Uu^Vud, Xu, Xu, Xu, Xu, Uu^Tf, Uh, Qxu, Uh, Qxu, Xu, Xu, Xu, Xu, Uu^Vud, Rr, Rr, Rr, Xu, Xu, Xu, Uu, Uu, Uu, Xu, Xu
Xu, Xu, Xu, Uu, Xu, Xu, Xu, Xu, Rr, 1 Rr, Rr, Xu, Xu, Xu, Xu, Xu, Xu, Xu, Xu, Xu, Xu, Xu, Xu, Xu, Xu, Xu, Rr, 2 Rr, Rr, Xu, Xu, Xu, Xu, Uu, Xu, Xu, Xu
Xu, Xu, Xu, Xu, Xu, Xu, Xu, Xu, Xu, Rr, Xu, Xu, Xu, Xu, Xu, Xu, Xu, Xu, Xu, Xu, Xu, Xu, Xu, Xu, Xu, Xu, Xu, Rr, Xu, Xu, Xu, Xu, Xu, Xu, Xu, Xu, Xu
Xu, Xu, Xu, Xu, Xu, Xu, Xu, Xu, Xu, Xu, Xu, Xu, Xu, Xu, Xu, Xu, Xu, Xu, Xu, Xu, Xu, Xu, Xu, Xu, Xu, Xu, Xu, Xu, Xu, Xu, Xu, Xu, Xu, Xu, Xu, Xu, Xu
