border_size=1
usage=map

Xu, Xu, Xu, Xu, Xu, Xu, Xu, Xu, Rr, Rr, Rr, Xu, Xu, Xu, Xu, Xu, Xu, Xu, Xu, Xu, Xu, Xu, Xu, Xu, Xu, Xu, Xu, Xu, Xu, Xu, Xu, Xu, Xu, Xu, Xu, Xu, Xu
Xu, Xu, Xu, Xu, Xu, Xu, Xu, Xu, Rr, Rr, Rr, Xu, Xu, Xu, Xu, Xu, Xu, Uu, Uu, Uu, Xu, Xu, Xu, Xu, Xu, Xu, Xu, Uh, Uh, Xu, Xu, Xu, Xu, Xu, Xu, Xu, Xu
Xu, Xu, Re, Xu, Xu, Xu, Xu, Xu, Rr, Rr, Rr, Xu, Xu, Xu, Xu, Xu, Xu, Xu, Cud, Xu, Xu, Xu, Xu, Xu, Xu, Xu, Rr, Xu, Uh, Xu, Xu, Xu, Xu, Xu, Re, Xu, Xu
Xu, Xu, Xu, Xu, Xu, Xu, Xu, Xu, Rr, Rr, Rr, Xu, Xu, Xu, Xu, Xu, Cud, Cud, Rr, Cud, Cud, Xu, Xu, Xu, Xu, Xu, Uh, Rr, Uh, Xu, Xu, Xu, Xu, Xu, Xu, Xu, Xu
Xu, Xu, Xu, Xu, Xu, Xu, Xu, Xu, Rr, Rr, Rr, Xu, Xu, Xu, Xu, Xu, Rr, Rr, Rr, Rr, Rr, Xu, Xu, Xu, Xu, Xu, Rr, Rr, Rr, Xu, Xu, Xu, Xu, Xu, Xu, Xu, Xu
Xu, Xu, Xu, Xu, Xu, Xu, Xu, Xu, Cud, Cud, Cud, Xu, Uu, Xu, Uu, Xu, Cud, Rr, Rr, Rr, Cud, Xu, Uu, Xu, Uu, Xu, Cud, Cud, Cud, Xu, Xu, Xu, Xu, Xu, Xu, Xu, Xu
Xu, Xu, Xu, Xu, Xu, Xu, Xu, Cud, Cud, 4 Kud, Cud, Cud, Uu, Uu, Uu, Uu, Xu, Rr, Rr, Rr, Xu, Uu, Uu, Uu, Uu, Cud, Cud, 5 Kud, Cud, Cud, Xu, Xu, Xu, Xu, Xu, Xu, Xu
Xu, Xu, Xu, Xu, Uu, Xu, Xu, Xu, Xu, Cud, Xu, Xu, Xu, Xu, Xu, Xu, Uh, Cud, Uu, Cud, Uh, Xu, Xu, Xu, Xu, Xu, Xu, Cud, Xu, Xu, Xu, Xu, Uu, Xu, Xu, Xu, Xu
Xu, Xu, Xu, Uu, Uu, Uu, Xu, Xu, Rr, Rr, Rr, Xu, Xu, Xu, Xu, Xu, Uu, Uu, Rr, Uu, Uu, Xu, Xu, Xu, Xu, Xu, Rr, Rr, Rr, Xu, Xu, Uu, Uu, Uu, Xu, Xu, Xu
Xu, Xu, Xu, Xu, Cud, Xu, Xu, Xu, Rr, Rr, Rr, Uu, Uh, Cud, Uu, Uh, Rr, Uu^Vud, Uu, Uu^Vud, Rr, Uh, Uu, Cud, Uh, Uu, Rr, Rr, Rr, Xu, Xu, Xu, Cud, Xu, Xu, Xu, Xu
Xu, Xu, Xu, Cud, Rr, Cud, Xu, Xu, Rr, Rr, Rr, Rr, Uu, Rr, Uu, Uu^Vud, Rr, Uu, Uh, Uu^Uf, Rr, Uu^Vud, Uu, Rr, Uu, Uu, Rr, Rr, Rr, Xu, Xu, Cud, Rr, Cud, Xu, Xu, Xu
Xu, Xu, Cud, Rr, Rr, Rr, Cud, Xu, Rr, Rr, Rr, Uu, Xu, Cud, Xu, Uu, Rr, Uu^Uf, Uu, Uu^Uf, Rr, Uu, Xu, Cud, Xu, Uu, Rr, Rr, Rr, Xu, Cud, Rr, Rr, Rr, Cud, Xu, Xu
Xu, Xu, Rr, Rr, Uu^Vud, Rr, Rr, Uu, Rr, Rr, Rr, Xu, Uu^Uf, Xu, Uu^Uf, Xu, Uu^Uf, Uu^Vud, Rr, Uu^Vud, Uh, Xu, Uu^Uf, Xu, Uh, Xu, Rr, Rr, Rr, Uu, Rr, Rr, Uu^Vud, Rr, Rr, Xu, Xu
Xu, Xu, Cud, Rr, Rr, Rr, Cud, Uu, Rr, Rr, Rr, Uu, Uu, Uh, Uu^Vud, Xu, Xu, Uu, Uu, Uu, Xu, Xu, Uu, Uu^Vud, Uu, Uu, Rr, Rr, Rr, Uu, Cud, Rr, Rr, Rr, Cud, Xu, Xu
Xu, Xu, Xu, Rr, Cud, Rr, Xu, Xu, Rr, Rr, Rr, Uu, Uh, Uu, Uu, Uh, Xu, Uh, Uu, Uu, Xu, Uu^Uf, Uh, Uu, Uu, Uu^Uf, Rr, Rr, Rr, Xu, Xu, Rr, Cud, Rr, Xu, Xu, Xu
Xu, Xu, Xu, Xu, Xu, Uu, Xu, Uu, Rr, Rr, Rr, Xu, Xu, Uu^Uf, Xu, Xu, Xu, Xu, Qxu^Bs|, Xu, Xu, Xu, Xu, Uu, Xu, Xu, Rr, Rr, Rr, Uu, Xu, Uu, Xu, Xu, Xu, Xu, Xu
Xu, Xu, Xu, Uh, Uu, Uu, Xu, Uu^Vud, Rr, Rr, Rr, Cud, Uu, Uh, Uu, Xu, Cud, Qxu, Cud, Qxu, Cud, Xu, Uh, Uu^Uf, Uu, Cud, Rr, Rr, Rr, Uu^Vud, Xu, Uu, Uu, Xu, Xu, Xu, Xu
Xu, Xu, Uu^Uf, Uu, Xu, Xu, Xu, Uu, Rr, Rr, Rr, Uu, Uu, Uu, Uu^Vud, Uu, Cud, Cud, 3 Kud, Cud, Cud, Uu, Uu^Vud, Uu, Uu, Uu, Rr, Rr, Rr, Uu, Xu, Uu^Uf, Uu, Uh, Xu, Xu, Xu
Xu, Xu, Uu, Uu, Uu, Xu, Xu, Xu, Rr, Rr, Rr, Uu, Uh, Uu, Uu, Uu, Cud, Cud, Cud, Cud, Cud, Uu, Uu, Uu, Uh, Uu, Rr, Rr, Rr, Xu, Uu^Uf, Xu, Xu, Uu, Uu^Uf, Xu, Xu
Xu, Xu, Xu, Uu^Vud, Rr, Uu, Uu, Uu, Rr, Rr, Rr, Cud, Xu, Uh, Xu, Xu, Xu, Qxu, Qxu^Bs|, Qxu, Xu, Xu, Xu, Uu, Xu, Cud, Rr, Rr, Rr, Uu, Uu, Xu, Rr, Uu, Xu, Xu, Xu
Xu, Xu, Uu^Uf, Rr, Rr, Rr, Uh, Uu, Rr, Rr, Rr, Xu, Uh, Uu^Uf, Uu, Xu, Xu, Xu, Uu, Xu, Xu, Xu, Uu, Uu^Uf, Xu, Xu, Rr, Rr, Rr, Uh, Uu, Rr, Rr, Rr, Uu, Xu, Xu
Xu, Xu, Uu, Rr, Rr, Rr, Uu, Xu, Rr, Rr, Rr, Uu, Uu, Uu, Uh, Xu, Xu, Uu, Qxu, Qxu, Xu, Uh, Uu^Vud, Uu, Uu, Uu, Rr, Rr, Rr, Xu, Xu, Rr, Rr, Rr, Uu^Uf, Uu^Uf, Xu
Xu, Xu, Xu, Uu^Vud, Uh, Uu^Uf, Uh, Xu, Rr, Rr, Rr, Uu, Uu^Uf, Uu^Vud, Xu, Xu, Uh, Uu, Qxu, Uu, Uu^Uf, Xu, Uu^Uf, Uu, Uh, Uu, Rr, Rr, Rr, Xu, Xu, Uu^Vud, Uh, Uu, Uu, Uu^Vud, Xu
Xu, Xu, Xu, Uu, Xu, Uu, Xu, Xu, Rr, Rr, Rr, Xu, Xu, Xu, Xu, Xu, Qxu, Uh, Qxu, Uu, Qxu, Xu, Xu, Xu, Xu, Xu, Rr, Rr, Rr, Xu, Xu, Xu, Xu, Uu, Xu, Uh, Xu
Xu, Xu, Rr, Rr, Rr, Xu, Cud, Cud, Rr, Rr, Rr, Rr, Uu, Cud, Uu, Uu^Uf, Uu, Qxu, Uu, Uu, Uu, Uu, Uh, Cud, Uu, Rr, Rr, Rr, Rr, Cud, Cud, Xu, Rr, Rr, Rr, Xu, Xu
Xu, Xu, Rr, Rr, Rr, Xu, Cud, Kud, Rr, Rr, Rr, Rr, Uu, Uu, Uh, Uu^Vud, Uu, Qxu, Uu, Qxu, Uu, Uu^Vud, Uu, Uu, Uh, Rr, Rr, Rr, Rr, Kud, Cud, Xu, Rr, Rr, Rr, Xu, Xu
Xu, Xu, Xu, Cud, Xu, Xu, Xu, Cud, Rr, Rr, Rr, Rr, Xu, Cud, Xu, Uu, Qxu, Qxu, Qxu, Qxu, Uu, Uh, Xu, Cud, Xu, Rr, Rr, Rr, Rr, Cud, Xu, Xu, Xu, Cud, Xu, Xu, Xu
Xu, Xu, Uu, Uu, Uu, Xu, Xu, Xu, Rr, Rr, Rr, Uu^Vud, Xu, Xu, Xu, Xu, Uu^Uf, Uh, Qxu, Uh, Qxu, Xu, Xu, Xu, Xu, Uu^Vud, Rr, Rr, Rr, Xu, Xu, Xu, Uu, Uu, Uu, Xu, Xu
Xu, Xu, Xu, Uu, Xu, Xu, Xu, Xu, Rr, 1 Rr, Rr, Xu, Xu, Xu, Xu, Xu, Xu, Xu, Xu, Xu, Xu, Xu, Xu, Xu, Xu, Xu, Rr, 2 Rr, Rr, Xu, Xu, Xu, Xu, Uu, Xu, Xu, Xu
Xu, Xu, Xu, Xu, Xu, Xu, Xu, Xu, Xu, Rr, Xu, Xu, Xu, Xu, Xu, Xu, Xu, Xu, Xu, Xu, Xu, Xu, Xu, Xu, Xu, Xu, Xu, Rr, Xu, Xu, Xu, Xu, Xu, Xu, Xu, Xu, Xu
Xu, Xu, Xu, Xu, Xu, Xu, Xu, Xu, Xu, Xu, Xu, Xu, Xu, Xu, Xu, Xu, Xu, Xu, Xu, Xu, Xu, Xu, Xu, Xu, Xu, Xu, Xu, Xu, Xu, Xu, Xu, Xu, Xu, Xu, Xu, Xu, Xu
