border_size=1
usage=map

Xu, Xu, Xu, Xu, Xu, Xu, Xu, Xu, Xu, Xu, Xu, Xu, Uh, Xu, Xu, Xu, Xu, Xu, Xu, Xu, Xu, Xu, Xu, Xu, Xu, Xu, Xu
Xu, Xu, Xu, Xu, Xu, Xu, Xu, Xu, Xu, Xu, Xu, Xu, Uu, Xu, Uh, Xu, Xu, Xu, Xu, Xu, Xu, Xu, Xu, Xu, Xu, Xu, Xu
Xu, Xu, Xu, Xu, Xu, Xu, Xu, Xu, Xu, Xu, Xu, Xu, Xu, Uu, Xu, Uh, Xu, Xu, Xu, Xu, Xu, Xu, Xu, Xu, Xu, Xu, Xu
Xu, Xu, Xu, Xu, Xu, Xu, Xu, Xu, Xu, Xu, Xu, Xu, Xu, Xu, Uu, Uu, Xu, Xu, Xu, Xu, Xu, Xu, Xu, Xu, Xu, Xu, Xu
Xu, Xu, Xu, Xu, Xu, Xu, Xu, Xu, Qlf, Xu, Xu, Xu, Xu, Xu, Uh, Xu, Xu, Xu, Xu, Xu, Xu, Xu, Xu, Xu, Xu, Xu, Xu
Xu, Xu, Xu, Xu, Xu, Xu, Xu, Xu, Qlf, Xu, Qlf, Xu, Xu, Uh, Xu, Xu, Xu, Xu, Xu, Xu, Qlf, Qlf, Xu, Xu, Xu, Xu, Xu
Xu, Xu, Xu, Xu, Xu, Xu, Xu, Xu, Xu, Qlf, Xu, Qlf, Qlf, Uu, Qlf, Xu, Xu, Xu, Qlf, Xu, Qlf, Qlf, Qlf, Xu, Xu, Xu, Xu
Xu, Xu, Xu, Xu, Xu, Xu, Xu, Xu, Xu, Xu, Qlf, Qlf, Qlf, Ql^Bs|, Qlf, Qlf, Qlf, Qlf, Xu, Qlf, Qlf, Qlf, Xu, Xu, Xu, Xu, Xu
Xu, Xu, Xu, Xu, Xu, Xu, Xu, Xu, Xu, Xu, Qlf, Cud, Cud, Cud, Cud, Cud, Qlf, Xu, Xu, Xu, Xu, Xu, Xu, Xu, Xu, Xu, Xu
Xu, Xu, Xu, Xu, Xu, Xu, Xu, Xu, Uu, Xu, Qlf, Qlf, Cud, 3 Kud, Cud, Qlf, Qlf, Xu, Uu, Xu, Xu, Xu, Xu, Xu, Xu, Xu, Xu
Xu, Xu, Xu, Xu, Xu, Xu, Uu^Vud, Qlf^Bs/, Qlf^Bs|, Qlf^Bs\, Uu^Vud, Qlf^Bs/, Qlf, Cud, Qlf, Qlf^Bs\, Uu^Vud, Qlf^Bs/, Ql^Bs|, Ql^Bs\, Uu^Vud, Xu, Xu, Xu, Xu, Xu, Xu
Xu, Xu, Xu, Xu, Xu, Xu, Ql^Bs|, Qlf, Uu, Qlf, Qlf^Bs|, Qlf^Bs\, Uu, Cud, Uu, Qlf^Bs/, Qlf^Bs|, Qlf, Uu, Qlf, Ql^Bs|, Xu, Xu, Xu, Xu, Xu, Xu
Xu, Xu, Xu, Xu, Xu, Xu, Uu, Qlf, Qlf^Bs|, Qlf, Uu, Qlf, Qlf^Bs|, Uu^Vud, Qlf^Bs|, Qlf, Uu, Qlf, Qlf^Bs|, Qlf, Uu, Xu, Xu, Xu, Xu, Xu, Xu
Xu, Xu, Xu, Xu, Xu, Xu, Qlf^Bs|, Qlf^Bs\, Uu^Vud, Qlf, Qlf^Bs|, Qlf, Uu, Qlf, Uu, Qlf, Qlf^Bs|, Qlf, Uu^Vud, Qlf^Bs/, Ql^Bs|, Xu, Xu, Xu, Xu, Xu, Xu
Xu, Xu, Xu, Xu, Xu, Qlf, Uu, Qlf, Ql^Bs|, Qlf^Bs\, Uu, Qlf^Bs/, Qlf, Uu, Qlf, Qlf^Bs\, Uu, Qlf^Bs/, Qlf^Bs|, Qlf, Uu, Ql, Xu, Xu, Xu, Xu, Xu
Xu, Xu, Xu, Xu, Uu, Qlf^Bs/, Qlf, Cud, Uu, Qlf, Ql^Bs|, Qlf, Cud, Qlf^Bs|, Cud, Qlf, Qlf^Bs|, Qlf, Uu, Cud, Qlf, Ql^Bs\, Uu, Xu, Xu, Xu, Xu
Xu, Xu, Xu, Uu, Uu^Vud, Uu, Uu, Qlf, Qlf, Cud, Uu, Qlf, Qlf^Bs/, Uu^Vud, Qlf^Bs\, Qlf, Uu, Cud, Qlf, Qlf, Uu, Uu, Uu^Vud, Uu, Xu, Xu, Xu
Xu, Xu, Xu, Uu, Uu, Uu, Uu, Uu, Uu, Qlf, Qlf, Uu, Qlf, Qlf, Qlf, Uu, Qlf, Qlf, Uu, Uu, Uu, Uu, Uu, Uu, Xu, Xu, Xu
Xu, Xu, Xu, Xu, Cud, Cud, Cud, Uu, Uu, Uu, Uu, Qlf^Bs|, Qlf, Qlf, Qlf, Qlf^Bs|, Uu, Uu, Uu, Uu, Cud, Cud, Cud, Xu, Xu, Xu, Xu
Xu, Xu, Xu, Xu, Xu, Cud, Cud, Cud, Uu, Uu, Uu, Uu^Vud, Qlf^Bs\, Qlf, Qlf^Bs/, Uu^Vud, Xu, Uu, Uu, Cud, Cud, Cud, Xu, Xu, Xu, Xu, Xu
Xu, Xu, Xu, Xu, Xu, 1 Kud, Xu, Cud, Xu, Xu, Qlf, Qlf, Cud, Uu, Cud, Qlf, Qlf, Xu, Xu, Cud, Xu, 2 Kud, Xu, Xu, Xu, Xu, Xu
Xu, Xu, Xu, Xu, Xu, Xu, Xu, Xu, Xu, Qlf, Xu, Xu, Rr, Rr, Rr, Xu, Xu, Qlf, Qlf, Xu, Xu, Xu, Xu, Xu, Xu, Xu, Xu
Xu, Xu, Xu, Xu, Xu, Xu, Xu, Xu, Qlf, Qlf, Xu, Xu, Rr, Rr, Rr, Xu, Xu, Xu, Xu, Qlf, Xu, Xu, Xu, Xu, Xu, Xu, Xu
Xu, Xu, Xu, Xu, Xu, Xu, Xu, Xu, Qxu, Xu, Xu, Xu, Rr, Rr, Rr, Xu, Xu, Xu, Qxu, Qlf, Xu, Xu, Xu, Xu, Xu, Xu, Xu
Xu, Xu, Xu, Xu, Xu, Xu, Xu, Xu, Xu, Xu, Xu, Xu, Rr, Rr, Rr, Xu, Xu, Xu, Xu, Qxu, Xu, Xu, Xu, Xu, Xu, Xu, Xu
Xu, Xu, Xu, Xu, Xu, Xu, Xu, Xu, Xu, Xu, Xu, Xu, Rr, Rr, Rr, Xu, Xu, Xu, Xu, Xu, Xu, Xu, Xu, Xu, Xu, Xu, Xu
Xu, Xu, Xu, Xu, Xu, Xu, Xu, Xu, Xu, Xu, Xu, Xu, Rr, Rr, Rr, Xu, Xu, Xu, Xu, Xu, Xu, Xu, Xu, Xu, Xu, Xu, Xu
