Xu, Xu, Xu, Xu, Xu, Xu, Xu, Xu, Xu, Xu, Xu, Xu, Uh, Xu, Xu, Xu, Xu, Xu, Xu, Xu, Xu, Xu, Xu, Xu, Xu, Xu, Xu
Xu, Xu, Xu, Xu, Xu, Xu, Xu, Xu, Xu, Xu, Xu, Xu, Uu, Xu, Uh, Xu, Xu, Xu, Xu, Xu, Xu, Xu, Xu, Xu, Xu, Xu, Xu
Xu, Xu, Xu, Xu, Xu, Xu, Xu, Xu, Xu, Xu, Xu, Xu, Xu, Uu^Tf, Xu, Uh, Xu, Xu, Xu, Xu, Xu, Xu, Xu, Xu, Xu, Xu, Xu
Xu, Xu, Xu, Xu, Xu, Xu, Xu, Xu, Xu, Xu, Xu, Xu, Xu, Xu, Uu^Tf, Uu^Em, Xu, Xu, Xu, Xu, Xu, Xu, Xu, Xu, Xu, Xu, Xu
Xu, Xu, Xu, Xu, Xu, Xu, Xu, Xu, Qlf, Xu, Xu, Xu, Xu, Xu, Uh^Em, Xu, Xu, Xu, Xu, Xu, Xu, Xu, Xu, Xu, Xu, Xu, Xu
Xu, Xu, Xu, Xu, Xu, Xu, Xu, Xu, Qlf, Xu, Qlf, Xu, Xu, Uh, Xu, Xu, Xu, Xu, Xu, Xu, Qlf, Qlf, Xu, Xu, Xu, Xu, Xu
Xu, Xu, Xu, Xu, Xu, Xu, Xu, Xu, Xu, Qlf, Xu, Qlf, Qlf, Urb, Qlf, Xu, Xu, Xu, Qlf, Xu, Qlf, Qlf, Qlf, Xu, Xu, Xu, Xu
Xu, Xu, Xu, Xu, Xu, Xu, Xu, Xu, Xu, Xu, Qlf, Qlf, Qlf, Qlf^Bs|, Qlf, Qlf, Qlf, Qlf, Xu, Qlf, Qlf, Qlf, Xu, Xu, Xu, Xu, Xu
Xu, Xu, Xu, Xu, Xu, Xu, Xu, Xu, Xu, Xu, Qlf, Cud, Cud, Cud, Cud, Cud, Qlf, Xu, Xu, Xu, Xu, Xu, Xu, Xu, Xu, Xu, Xu
Xu, Xu, Xu, Xu, Xu, Xu, Xu, Xu, Uu^Em, Xu, Qlf, Qlf, Cud, 3 Kud, Cud, Qlf, Qlf, Xu, Uu, Xu, Xu, Xu, Xu, Xu, Xu, Xu, Xu
Xu, Xu, Xu, Xu, Xu, Xu, Urb^Vud, Qlf^Bs/, Qlf^Bs|, Qlf^Bs\, Urb^Vud, Qlf^Bs/, Qlf, Cud, Qlf, Qlf^Bs\, Urb^Vud, Qlf^Bs/, Qlf^Bs|, Qlf^Bs\, Uu^Vud, Xu, Xu, Xu, Xu, Xu, Xu
Xu, Xu, Xu, Xu, Xu, Xu, Qlf^Bs|, Qlf, Uh, Qlf, Qlf, Qlf^Bs\, Urb, Cud, Urb, Qlf^Bs/, Qlf^Bs|, Qlf, Uh, Qlf, Qlf^Bs|, Xu, Xu, Xu, Xu, Xu, Xu
Xu, Xu, Xu, Xu, Xu, Xu, Urb, Qlf, Qlf^Bs|, Qlf, Uh, Qlf, Qlf^Bs|, Urb^Vud, Qlf^Bs|, Qlf, Uh, Qlf, Qlf^Bs|, Qlf, Uu, Xu, Xu, Xu, Xu, Xu, Xu
Xu, Xu, Xu, Xu, Xu, Xu, Qlf^Bs|, Qlf^Bs\, Urb^Vud, Qlf, Qlf^Bs|, Qlf, Urb, Qlf, Urb, Qlf, Qlf, Qlf, Urb^Vud, Qlf^Bs/, Qlf^Bs|, Xu, Xu, Xu, Xu, Xu, Xu
Xu, Xu, Xu, Xu, Xu, Qlf, Urb, Qlf, Qlf, Qlf^Bs\, Urb, Qlf^Bs/, Qlf, Urb^Em, Qlf, Qlf^Bs\, Urb, Qlf^Bs/, Qlf, Qlf, Urb, Qlf, Xu, Xu, Xu, Xu, Xu
Xu, Xu, Xu, Xu, Uu, Qlf^Bs/, Qlf, Cud, Uu, Qlf, Qlf^Bs|, Qlf, Qlf, Qlf^Bs|, Qlf, Qlf, Qlf^Bs|, Qlf, Uu, Cud, Qlf, Qlf^Bs\, Uu, Xu, Xu, Xu, Xu
Xu, Xu, Xu, Uu, Urb^Vud, Uu, Uu^Es, Qlf, Qlf, Cud, Urb, Qlf, Qlf^Bs/, Urb^Vud, Qlf^Bs\, Qlf, Urb, Cud, Qlf, Qlf, Uu^Em, Uu, Urb^Vud, Uu, Xu, Xu, Xu
Xu, Xu, Xu, Uu, Uu^Em, Uu, Uu, Uu, Uu, Qlf, Qlf, Urb, Qlf, Qlf, Qlf, Urb, Qlf, Qlf, Uu, Uu, Uu, Uu, Uu, Uu, Xu, Xu, Xu
Xu, Xu, Xu, Xu, Cud, Cud, Cud, Uu^Tf, Uu, Uu, Uu, Qlf^Bs|, Qlf, Qlf, Qlf, Qlf^Bs|, Uu, Uu^Es, Uu, Uu^Tf, Cud, Cud, Cud, Xu, Xu, Xu, Xu
Xu, Xu, Xu, Xu, Xu, Cud, Cud, Cud, Uu, Uu^Em, Uu, Urb^Vud, Qlf^Bs\, Qlf, Qlf^Bs/, Urb^Vud, Xu, Uu, Uu, Cud, Cud, Cud, Xu, Xu, Xu, Xu, Xu
Xu, Xu, Xu, Xu, Xu, 1 Kud, Xu, Cud, Xu, Xu, Qlf, Qlf, Rd^Es, Uu, Rd^Es, Qlf, Qlf, Xu, Xu, Cud, Xu, 2 Kud, Xu, Xu, Xu, Xu, Xu
Xu, Xu, Xu, Xu, Xu, Xu, Xu, Xu, Xu, Qlf, Xu, Xu, Cud, Rd, Cud, Xu, Xu, Qlf, Qlf, Xu, Xu, Xu, Xu, Xu, Xu, Xu, Xu
Xu, Xu, Xu, Xu, Xu, Xu, Xu, Xu, Qlf, Qlf, Xu, Xoa, Rr, Rr, Rr, Xoa, Xu, Xu, Xu, Qlf, Xu, Xu, Xu, Xu, Xu, Xu, Xu
Xu, Xu, Xu, Xu, Xu, Xu, Xu, Xu, Qxu, Xu, Xu, Xoa, Rr, Rr, Rr, Xoa, Xu, Xu, Qxu, Qlf, Xu, Xu, Xu, Xu, Xu, Xu, Xu
Xu, Xu, Xu, Xu, Xu, Xu, Xu, Xu, Xu, Xu, Xu, Xoa, Rr, Rr, Rr, Xoa, Xu, Xu, Xu, Qxu, Xu, Xu, Xu, Xu, Xu, Xu, Xu
Xu, Xu, Xu, Xu, Xu, Xu, Xu, Xu, Xu, Xu, Xu, Xoa, Rr, Rr, Rr, Xoa, Xu, Xu, Xu, Xu, Xu, Xu, Xu, Xu, Xu, Xu, Xu
Xu, Xu, Xu, Xu, Xu, Xu, Xu, Xu, Xu, Xu, Xu, Xoa, Rr, Rr, Rr, Xoa, Xu, Xu, Xu, Xu, Xu, Xu, Xu, Xu, Xu, Xu, Xu
