border_size=1
usage=map

Xu, Xu, Xu, Xu, Xu, Xu, Xu, Xu, Xu, Xu, Xu, Xu, Uh, Xu, Xu, Xu, Xu, Xu, Xu, Xu, Xu, Xu, Xu, Xu, Xu, Xu, Xu
Xu, Xu, Xu, Xu, Xu, Xu, Xu, Xu, Xu, Xu, Xu, Xu, Uu, Xu, Uh, Xu, Xu, Xu, Xu, Xu, Xu, Xu, Xu, Xu, Xu, Xu, Xu
Xu, Xu, Xu, Xu, Xu, Xu, Xu, Xu, Xu, Xu, Xu, Xu, Xu, Uu, Xu, Uh, Xu, Xu, Xu, Xu, Xu, Xu, Xu, Xu, Xu, Xu, Xu
Xu, Xu, Xu, Xu, Xu, Xu, Xu, Xu, Xu, Xu, Xu, Xu, Xu, Xu, Uu, Uu, Xu, Xu, Xu, Xu, Xu, Xu, Xu, Xu, Xu, Xu, Xu
Xu, Xu, Xu, Xu, Xu, Xu, Xu, Xu, Qlf, Xu, Xu, Xu, Xu, Xu, Uh, Xu, Xu, Xu, Xu, Xu, Xu, Xu, Xu, Xu, Xu, Xu, Xu
Xu, Xu, Xu, Xu, Xu, Xu, Xu, Xu, Qlf, Xu, Qlf, Xu, Xu, Uh, Xu, Xu, Xu, Xu, Xu, Xu, Qlf, Qlf, Xu, Xu, Xu, Xu, Xu
Xu, Xu, Xu, Xu, Xu, Xu, Xu, Xu, Xu, Qlf, Xu, Qlf, Ql, Uu, Ql, Xu, Xu, Xu, Qlf, Xu, Qlf, Qlf, Qlf, Xu, Xu, Xu, Xu
Xu, Xu, Xu, Xu, Xu, Xu, Xu, Xu, Xu, Xu, Ql, Ql, Qlf, Ql^Bs|, Qlf, Ql, Ql, Ql, Xu, Qlf, Qlf, Qlf, Xu, Xu, Xu, Xu, Xu
Xu, Xu, Xu, Xu, Xu, Xu, Xu, Xu, Xu, Xu, Ql, Cud, Cud, Cud, Cud, Cud, Ql, Xu, Xu, Xu, Xu, Xu, Xu, Xu, Xu, Xu, Xu
Xu, Xu, Xu, Xu, Xu, Xu, Xu, Xu, Uu, Xu, Ql, Qlf, Cud, 3 Kud, Cud, Qlf, Ql, Xu, Uu, Xu, Xu, Xu, Xu, Xu, Xu, Xu, Xu
Xu, Xu, Xu, Xu, Xu, Xu, Uu^Vud, Ql^Bs/, Ql^Bs|, Ql^Bs\, Uu^Vud, Ql^Bs/, Qlf, Cud, Qlf, Ql^Bs\, Uu^Vud, Ql^Bs/, Ql^Bs|, Ql^Bs\, Uu^Vud, Xu, Xu, Xu, Xu, Xu, Xu
Xu, Xu, Xu, Xu, Xu, Xu, Ql^Bs|, Ql, Uu, Ql, Ql^Bs|, Ql^Bs\, Uu, Cud, Uu, Ql^Bs/, Ql^Bs|, Ql, Uu, Ql, Ql^Bs|, Xu, Xu, Xu, Xu, Xu, Xu
Xu, Xu, Xu, Xu, Xu, Xu, Uu, Ql, Ql^Bs|, Ql, Uu, Ql, Ql^Bs|, Uu^Vud, Ql^Bs|, Ql, Uu, Ql, Ql^Bs|, Ql, Uu, Xu, Xu, Xu, Xu, Xu, Xu
Xu, Xu, Xu, Xu, Xu, Xu, Ql^Bs|, Ql^Bs\, Uu^Vud, Ql, Ql^Bs|, Ql, Uu, Ql, Uu, Ql, Ql^Bs|, Ql, Uu^Vud, Ql^Bs/, Ql^Bs|, Xu, Xu, Xu, Xu, Xu, Xu
Xu, Xu, Xu, Xu, Xu, Ql, Uu, Ql, Ql^Bs|, Ql^Bs\, Uu, Ql^Bs/, Ql, Uu, Ql, Ql^Bs\, Uu, Ql^Bs/, Ql^Bs|, Ql, Uu, Ql, Xu, Xu, Xu, Xu, Xu
Xu, Xu, Xu, Xu, Uu, Ql^Bs/, Ql, Cud, Uu, Ql, Ql^Bs|, Ql, Cud, Ql^Bs|, Cud, Ql, Ql^Bs|, Ql, Uu, Cud, Ql, Ql^Bs\, Uu, Xu, Xu, Xu, Xu
Xu, Xu, Xu, Uu, Uu^Vud, Uu, Uu, Ql, Ql, Cud, Uu, Ql, Ql^Bs/, Uu^Vud, Ql^Bs\, Ql, Uu, Cud, Ql, Ql, Uu, Uu, Uu^Vud, Uu, Xu, Xu, Xu
Xu, Xu, Xu, Uu, Uu, Uu, Uu, Uu, Uu, Ql, Ql, Uu, Ql, Ql, Ql, Uu, Ql, Ql, Uu, Uu, Uu, Uu, Uu, Uu, Xu, Xu, Xu
Xu, Xu, Xu, Xu, Cud, Cud, Cud, Uu, Uu, Uu, Uu, Ql^Bs|, Ql, Ql, Ql, Ql^Bs|, Uu, Uu, Uu, Uu, Cud, Cud, Cud, Xu, Xu, Xu, Xu
Xu, Xu, Xu, Xu, Xu, Cud, Cud, Cud, Uu, Uu, Uu, Uu^Vud, Ql^Bs\, Ql, Ql^Bs/, Uu^Vud, Xu, Uu, Uu, Cud, Cud, Cud, Xu, Xu, Xu, Xu, Xu
Xu, Xu, Xu, Xu, Xu, 1 Kud, Xu, Cud, Xu, Xu, Ql, Ql, Cud, Uu, Cud, Ql, Ql, Xu, Xu, Cud, Xu, 2 Kud, Xu, Xu, Xu, Xu, Xu
Xu, Xu, Xu, Xu, Xu, Xu, Xu, Xu, Xu, Ql, Xu, Xu, Rr, Rr, Rr, Xu, Xu, Ql, Ql, Xu, Xu, Xu, Xu, Xu, Xu, Xu, Xu
Xu, Xu, Xu, Xu, Xu, Xu, Xu, Xu, Ql, Ql, Xu, Xu, Rr, Rr, Rr, Xu, Xu, Xu, Xu, Ql, Xu, Xu, Xu, Xu, Xu, Xu, Xu
Xu, Xu, Xu, Xu, Xu, Xu, Xu, Xu, Qxu, Xu, Xu, Xu, Rr, Rr, Rr, Xu, Xu, Xu, Qxu, Ql, Xu, Xu, Xu, Xu, Xu, Xu, Xu
Xu, Xu, Xu, Xu, Xu, Xu, Xu, Xu, Xu, Xu, Xu, Xu, Rr, Rr, Rr, Xu, Xu, Xu, Xu, Qxu, Xu, Xu, Xu, Xu, Xu, Xu, Xu
Xu, Xu, Xu, Xu, Xu, Xu, Xu, Xu, Xu, Xu, Xu, Xu, Rr, Rr, Rr, Xu, Xu, Xu, Xu, Xu, Xu, Xu, Xu, Xu, Xu, Xu, Xu
Xu, Xu, Xu, Xu, Xu, Xu, Xu, Xu, Xu, Xu, Xu, Xu, Rr, Rr, Rr, Xu, Xu, Xu, Xu, Xu, Xu, Xu, Xu, Xu, Xu, Xu, Xu
