Hh, Gg, Gg, Gs^Fp, Gg, Gg, Gg, Hh, Hh, Hh, Hh, Hh, Mm, Mm, Hh, Hh, Hh, Gg, Gs^Fp, Gs^Fp, Gs^Fp, Gg, Gs^Fp, Gg, Gs^Fp, Gg, Gg, Gg, Gg, Gg, Gg, Gg, Gg, Gs^Fp, Gg, Gg, Gg, Gg
Gg, Gg, Gg^Efm, Gg, Gs^Fp, Gg, Hh, Mm, Hh, Mm, Mm, Mm, Mm, Mm, Hh, Mm, Hh, Gg, Gg, Gg^Ve, Gs^Fp, Gg, Gg, Gs^Fp, Gs^Fp, Gs^Fp, Gs^Fp, Gg, Gg, Gg, Gg, Gg, Gg, Gg, Gs^Fp, Gg, Gs^Fp, Gg
Gg, Gg, Gg, Gg, Gg^Ve, Gs^Fp, Hh^Fms, Hh, Mm, Gs^Fp, Gs^Fp, Mm, Mm, Gs^Fp, Hh^Em, Gs^Fp, Gs^Fp, Gg, Cv, Gs^Fp, Cv, Gg, Hh, Gg^Fet, Gg, Gg, Gs^Fp, Gg, Gg, Gg^Efm, Gg, Gg, Gg, Gg, Gs^Fp, Gs^Fp, Gg^Fet, Gs^Fp
Gg, Gg, Gg, Gg, Gs^Fp, Gs^Fp, Mm, Hh, Mm, Gs^Fp, Mm, Mm, Hh, Gs^Fp, Gs^Fp, Gs^Fp, Gs^Fet, Cv, Cv, 4 Kv, Cv, Cv, Gs^Fp, Hh, Hh, Gg, Hh^Fms, Gs^Fp, Gg, Gg, Gg, Gg, Gg^Ve, Gg, Gs^Fp, Gs^Fp, Gs^Fp, Gg
Gg, Gg, Gs^Fp, Gs^Fp, Gg^Efm, Hh^Fms, Mm, Mm, Mm, Hh^Fds, Hh, Hh, Hh, Hh^Fms, Gg, Gs^Fp, Gs^Fp, Cv, Cv, Cv, Cv, Cv, Hh^Fms, Hh, Mm, Hh, Hh, Hh, Gs^Fp, Gg, Gg, Gg, Gg, Gg, Gg, Gs^Fp, Gs^Fp, Gg
Gg, Gg, Gs^Fp, Gs^Fp, Gs^Fp, Hh, Mm, Mm, Hh, Hh, Hh^Fds, Hh, Gg, Hh, Gg, Gg, Gs^Fp, Hh, Mm, Gg, Hh, Gg, Hh, Hh, Mm, Mm, Hh, Hh^Fms, Hh, Gg, Gg, Gg, Gg, Gg, Gg, Gg, Hh, Hh
Gg^Efm, Gg, Gs^Fp, Gg^Vh, Mm, Mm, Mm, Hh, Hh, Hh, Gg, Gg, Gg, Gg, Gg, Gg^Vh, Hh, Gs^Fp, Mm, Hh, Mm, Hh, Hh, Hh, Hh, Hh, Hh, Hh, Hh, Gg, Gg, Gg^Efm, Gg, Gg, Hh, Gg, Mm, Mm
Gg, Gg, Hh, Hh, Hh^Es, Mm, Hh, Hh^Fms, Gs^Fp, Gg, Gs^Fp, Gs^Fp, Gs^Fet, Gs^Fp, Gg, Gs^Fp, Hh, Hh, Mm, Mm, Mm, Mm, Hh, Mm, Mm, Hh, Mm, Mm, Hh^Es, Hh, Hh, Gg, Gg, Gg, Hh, Hh^Fds, Mm, Mm
Gg, Gg, Hh, Hh^Fds, Gs^Fp, Hh, Hh, Gs^Fp, Gg, Gs^Fp, Gs^Fp, Gs^Fp, Gg, Gs^Fp, Gg, Gg, Hh, Hh, Hh^Fds, Mm, Hh^Es, Hh, Hh, Mm, Hh, Mm, Mm, Mm, Gg, Hh^Fds, Gg, Gg, Gs^Fp, Hh, Mm, Mm, Mm, Ww
Gg, Gg, Hh, Hh^Fms, Gs^Fp, Gs^Fp, Gg, Gg, Gg, Gg, Gg, Gg, Gg^Vh, Gg, Gg, Gg, Hh, Mm, Hh, Hh, Hh, Hh^Fms, Hh, Hh, Gs^Fp, Hh, Hh, Hh, Hh, Hh, Gg, Gg, Gs^Fp, Hh, Hh, Mm, Mm, Mm
Gg, Hh^Fds, Gg, Gg, Gg, Gs^Fp, Gg, Gg, Gg, Gg, Gs^Fp, Gg, Gg, Gg, Gg, Gg, Hh^Es, Hh, Hh^Fds, Hh, Hh^Fms, Gs^Fet, Gs^Fp, Hh, Gs^Fp, Hh, Gg, Hh, Gg, Gg, Gg, Gg^Ve, Gs^Fp, Hh^Em, Gs^Fp, Mm, Gg, Hh
Gg, Gg, Gg, Gg, Gg, Gg, Gg, Hh^Em, Gg, Gs^Fp, Gs^Fp, Gg, Gg, Gg^Efm, Gg, Gg, Gs^Fp, Hh, Hh, Hh, Hh, Gs^Fp, Gs^Fp, Gs^Fp, Gg, Gg, Gg, Gg, Gs^Fp, Gg, Gs^Fp, Gs^Fp, Gg, Gs^Fp, Gs^Fp, Hh, Gg, Gg
Gg, Gg, Gg, Gs^Fp, Gs^Fp, Gs^Fp, Gg, Gg, Gg, Gs^Fp, Gs^Fp, Gs^Fp, Gs^Fp, Gg, Gg, Gg^Vh, Hh, Hh, Hh^Fds, Hh, Gg, Gs^Fp, Gg^Ve, Gs^Fp, Gg^Efm, Gg, Gg, Gs^Fp, Gs^Fet, Gg, Gg, Gg, Gg, Gg, Gg, Gg, Ss, Gg
Gg, Gg, Gs^Fp, Gg, Gs^Fp, Gs^Fp, Gs^Fp, Gg, Gg, Gg, Gg^Ve, Gg^Efm, Gg, Gs^Fp, Gg, Gg, Gs^Fp, Hh, Hh, Hh, Gg, Gs^Fp, Gs^Fp, Gs^Fp, Gg, Gg, Gg, Gs^Fp, Gs^Fp, Gs^Fp, Gg, Gg, Gg, Gs^Fp, Gs^Fp, Gs^Fp, Ss, Gg
Gg, Gs^Fp, Gg^Ve, Gg, Gg, Gs^Fp, Gs^Fp, Gs^Fp, Gs^Fp, Gs^Fp, Gs^Fp, Gs^Fp, Gg, Gg, Gg, Gg, Gg, Hh, Gg, Gg, Gg, Gs^Fp, Gg, Gs^Fp, Gs^Fp, Gg, Gs^Fp, Gg, Gg, Gs^Fp, Gg, Gg, Ds, Gg, Ds, Gs^Fp, Ww^Ewl, Gg^Vh
Gg, Gs^Fp, Gg, Gs^Fp, Gg, Gg, Gg, Gs^Fp, Gs^Fp, Gs^Fet, Gs^Fp, Gs^Fp, Gg, Gg, Gg^Efm, Gg, Gg, Hh^Fds, Gg, Gg, Gg^Efm, Gg, Gg, Gg, Gs^Fp, Gs^Fp, Gs^Fp, Gg, Gs^Fp, Gg, Gg, Gg, Ds, Gg, Ds, Ds, Ww, Ww
Hh, Gs^Fp, Gg, Gg, Gg, Gg, Gg^Efm, Gg, Gg, Gs^Fp, Gg, Gg, Gg, Gg^Efm, Gg^Efm, Gg, Gg, Gs^Fp, Gg, Gg, Gg, Gg, Gg, Gs^Fp, Gg, Gg, Gg, Gs^Fp, Gg, Gs^Fp, Gs^Fp, Gg, Ww, Ds, Ww, Ww, Gg, Ds
Hh, Gg, Gg, Gg, Ww, Gg, Gg, Gg, Gg, Gg, Gs^Fp, Gg, Gg, Gg, Gg, Gg, Gg^Vh, Gg, Gs^Fp, Gg, Gs^Fp, Gg, Gg, Gg, Gg, Gg, Gg, Gg, Gg, Gg^Ve, Gs^Fp, Gs^Fp, Ww, Ww, Ds, Ds, Gg, Gg
Hh, Gg, Gg^Efm, Ww, Ww, Ww, Ww, Gg, Gg, Gs^Fp, Gg, Gs^Fp, Gg, Gg, Gg, Gg, Gg, Gg, Gg, Gs^Fp, Ds, Gs^Fp, Ss, Gg, Ss, Gg, Gg, Gg, Gg, Gs^Fp, Gs^Fp, Gg^Efm, Ww, Ds, Gs^Fp, Gg, Gg, Gg
Gg, Gg, Gg, Ww, Ww, Ww, Ww, Gg, Gg^Efm, Gg, Gg, Gg, Gg, Gg, Gs^Fp, Gg, Gg, Gg, Gg, Gg, Gg, Gs^Fp, Gs^Fp, Ss, Ss, Gg, Gg, Gg, Gg, Gg, Gs^Fp, Gs^Fp, Gs^Fp, Gs^Fp, Gg, Gg, Gg^Vh, Gg
Gg, Gg, Gg, Ww^Ewf, Ww, Ww, Gg, Gg, Gg, Gg, Gg^Ve, Gs^Fp, Gg, Gg, Ds, Gg, Gs^Fp, Hh, Hh, Hh, Hh^Fms, Ds, Gg, Gs^Fp, Gs^Fp, Gg, Gg, Gg, Gs^Fp, Gg, Gs^Fp, Gs^Fp, Gg, Ww^Ewf, Gg, Ds, Ww, Hh
Gs^Fp, Gg, Gs^Fp, Gg, Ww, Ww, Ww, Gg, Gg, Gs^Fp, Gs^Fp, Gs^Fp, Hh, Gg, Mm^Xm, Gs^Fp, Mm, Hh^Fms, Hh, Hh, Mm, Hh, Mm^Xm, Gg^Ve, Gg, Ss, Gs^Fp, Gs^Fp, Gs^Fp, Gg, Gg, Gg, Gg, Ww, Gg, Gg, Ww, Ww
Gg, Gs^Fp, Gs^Fp, Gg, Gg, Ww, Ww, Ww, Gg, Gg, Ch, Gs^Fp, Hh, Hh^Fds, Mm^Xm, Mm^Xm, Xu, Uu, Cud, Uu, Xu, Mm^Xm, Mm^Xm, Gg, Gg, Gs^Fp, Ch, Gs^Fp, Gg^Efm, Gs^Fp, Gg, Gg, Gg, Ww, Ww, Gg, Ww, Ww
Gg, Gg, Gg, Gs^Fp, Gs^Fp, Gg, Ww^Ewf, Gg, Hh, Ch, Ch, Ch, Hh^Es, Mm, Mm^Xm, Mm^Xm, Xu, Cud, 3 Kud, Cud, Xu, Mm^Xm, Mm^Xm, Hh, Hh, Ch, Ch, Ch, Gg, Gg, Gg, Gg, Ww^Ewf, Ww, Ww, Ww, Ww, Ww
Gs^Fp, Gg^Fet, Gg^Efm, Gg^Ve, Gs^Fp, Gg, Hh, Hh, Hh^Fms, Ch, Ch, 1 Kh, Mm, Mm, Mm^Xm, Mm^Xm, Xu, Cud, Cud, Cud, Xu, Md^Xm, Mm^Xm, Hh, Hh, 2 Kh, Ch, Ch, Gg, Gg, Gg, Gg, Ww, Ww, Ww, Ww, Ww, Ww
Gs^Fp, Gg, Gs^Fp, Gs^Fp, Hh, Gg, Hh^Fds, Hh^Es, Hh, Mm, Mm^Xm, Mm^Xm, Mm^Xm, Mm^Xm, Md^Xm, Md^Xm, Md^Xm, Xu, Xu, Xu, Md^Xm, Md^Xm, Md^Xm, Mm^Xm, Hh, Gg, Gs^Fp, Gs^Fp, Gg, Gg, Gg, Ww, Ww, Gg^Efm, Ww, Ww, Hh, Ww
Gg, Gs^Fp, Hh^Fms, Hh, Hh, Hh, Hh, Hh, Mm, Hh, Mm^Xm, Mm^Xm, Md^Xm, Md^Xm, Md^Xm, Md^Xm, Md^Xm, Md^Xm, Md^Xm, Md^Xm, Md^Xm, Md^Xm, Md^Xm, Mm^Xm, Hh^Fms, Gs^Fp, Gs^Fp, Gs^Fp, Gg, Gg, Gg, Gs^Fp, Gs^Fp, Ww, Gg, Ww, Hh^Es, Mm
Gg, Hh, Mm, Hh, Mm, Hh^Vhh, Mm^Xm, Mm, Mm^Xm, Mm^Xm, Mm^Xm, Mm^Xm, Md^Xm, Md^Xm, Md^Xm, Md^Xm, Md^Xm, Md^Xm, Md^Xm, Md^Xm, Md^Xm, Md^Xm, Md^Xm, Mm^Xm, Mm, Gs^Fp, Gs^Fp, Gs^Fp, Gg, Gg^Efm, Gg, Gg, Gs^Fet, Ww, Hh^Fds, Ds, Hh, Mm
Gg, Hh^Es, Mm, Mm, Mm^Xm, Mm^Xm, Mm^Xm, Mm^Xm, Md^Xm, Md^Xm, Md^Xm, Md^Xm, Md^Xm, Md^Xm, Md^Xm, Md^Xm, Md^Xm, Md^Xm, Md^Xm, Md^Xm, Md^Xm, Md^Xm, Md^Xm, Mm^Xm, Mm, Mm, Hh^Es, Hh, Ss, Gg, Hh, Gg, Gs^Fp, Gg^Vh, Hh, Hh, Mm, Mm^Xm
Gg, Hh, Mm^Xm, Mm^Xm, Md^Xm, Mm^Xm, Md^Xm, Md^Xm, Md^Xm, Md^Xm, Md^Xm, Md^Xm, Md^Xm, Md^Xm, Md^Xm, Md^Xm, Md^Xm, Md^Xm, Md^Xm, Md^Xm, Md^Xm, Md^Xm, Md^Xm, Mm^Xm, Mm^Xm, Hh, Mm^Xm, Hh^Em, Hh, Hh, Md^Xm, Hh, Gg, Gg, Hh, Mm, Mm, Mm^Xm
Mm^Xm, Mm^Xm, Md^Xm, Md^Xm, Md^Xm, Md^Xm, Md^Xm, Md^Xm, Md^Xm, Md^Xm, Md^Xm, Md^Xm, Md^Xm, Md^Xm, Md^Xm, Md^Xm, Md^Xm, Md^Xm, Md^Xm, Md^Xm, Md^Xm, Md^Xm, Md^Xm, Mm^Xm, Md^Xm, Mm^Xm, Md^Xm, Mm^Xm, Mm^Xm, Hh, Md^Xm, Md^Xm, Hh, Hh^Es, Mm^Xm, Mm^Xm, Mm^Xm, Mm^Xm
Mm^Xm, Md^Xm, Md^Xm, Md^Xm, Md^Xm, Md^Xm, Md^Xm, Md^Xm, Md^Xm, Md^Xm, Md^Xm, Md^Xm, Md^Xm, Md^Xm, Md^Xm, Md^Xm, Md^Xm, Md^Xm, Md^Xm, Md^Xm, Md^Xm, Md^Xm, Md^Xm, Md^Xm, Md^Xm, Md^Xm, Md^Xm, Md^Xm, Md^Xm, Mm^Xm, Mm^Xm, Md^Xm, Mm^Xm, Mm^Xm, Mm^Xm, Mm^Xm, Md^Xm, Md^Xm
Md^Xm, Md^Xm, Md^Xm, Md^Xm, Md^Xm, Md^Xm, Md^Xm, Md^Xm, Md^Xm, Md^Xm, Md^Xm, Md^Xm, Md^Xm, Md^Xm, Md^Xm, Md^Xm, Md^Xm, Md^Xm, Md^Xm, Md^Xm, Md^Xm, Md^Xm, Md^Xm, Md^Xm, Md^Xm, Md^Xm, Md^Xm, Md^Xm, Md^Xm, Md^Xm, Md^Xm, Md^Xm, Md^Xm, Md^Xm, Md^Xm, Md^Xm, Md^Xm, Md^Xm
