border_size=1
usage=map

Hh          , Gg          , Gg          , Gs^Fp       , Gg          , Gg          , Gg          , Hh          , Hh          , Hh          , Hh          , Hh          , Mm          , Mm          , Hh          , Hh          , Hh          , Gg          , Gs^Fp       , Gs^Fp       , Gs^Fp       , Gg          , Gs^Fp       , Gg          , Gs^Fp       , Gg          , Gg          , Gg          , Gg          , Gg          , Gg          , Gg          , Gg          , Gs^Fp       , Gg          , Gg          , Gg          , Gg          
Gg          , Gg          , Gg          , Gg          , Gs^Fp       , Gg          , Hh          , Mm          , Hh          , Mm          , Mm          , Mm          , Mm          , Mm          , Hh          , Mm          , Hh          , Gg          , Gg          , Gg^Ve       , Gs^Fp       , Gg          , Gg          , Gs^Fp       , Gs^Fp       , Gs^Fp       , Gs^Fp       , Gg          , Gg          , Gg          , Gg          , Gg          , Gg          , Gg          , Gs^Fp       , Gg          , Gs^Fp       , Gg          
Gg          , Gg          , Gg          , Gg          , Gg^Ve       , Gs^Fp       , Hh          , Hh          , Mm          , Gs^Fp       , Gs^Fp       , Mm          , Mm          , Gs^Fp       , Hh          , Gs^Fp       , Gs^Fp       , Gg          , Cv          , Gs^Fp       , Cv          , Gg          , Hh          , Gg          , Gg          , Gg          , Gs^Fp       , Gg          , Gg          , Gg          , Gg          , Gg          , Gg          , Gg          , Gs^Fp       , Gs^Fp       , Gg          , Gs^Fp       
Gg          , Gg          , Gg          , Gg          , Gs^Fp       , Gs^Fp       , Mm          , Hh          , Mm          , Gs^Fp       , Mm          , Mm          , Hh          , Gs^Fp       , Gs^Fp       , Gs^Fp       , Gs^Fp       , Cv          , Cv          , 4 Kv        , Cv          , Cv          , Gs^Fp       , Hh          , Hh          , Gg          , Hh          , Gs^Fp       , Gg          , Gg          , Gg          , Gg          , Gg^Ve       , Gg          , Gs^Fp       , Gs^Fp       , Gs^Fp       , Gg          
Gg          , Gg          , Gs^Fp       , Gs^Fp       , Gg          , Hh          , Mm          , Mm          , Mm          , Hh          , Hh          , Hh          , Hh          , Hh          , Gg          , Gs^Fp       , Gs^Fp       , Cv          , Cv          , Cv          , Cv          , Cv          , Hh          , Hh          , Mm          , Hh          , Hh          , Hh          , Gs^Fp       , Gg          , Gg          , Gg          , Gg          , Gg          , Gg          , Gs^Fp       , Gs^Fp       , Gg          
Gg          , Gg          , Gs^Fp       , Gs^Fp       , Gs^Fp       , Hh          , Mm          , Mm          , Hh          , Hh          , Hh          , Hh          , Gg          , Hh          , Gg          , Gg          , Gs^Fp       , Hh          , Mm          , Gg          , Hh          , Gg          , Hh          , Hh          , Mm          , Mm          , Hh          , Hh          , Hh          , Gg          , Gg          , Gg          , Gg          , Gg          , Gg          , Gg          , Hh          , Hh          
Gg          , Gg          , Gs^Fp       , Gg^Vh       , Mm          , Mm          , Mm          , Hh          , Hh          , Hh          , Gg          , Gg          , Gg          , Gg          , Gg          , Gg^Vh       , Hh          , Gs^Fp       , Mm          , Hh          , Mm          , Hh          , Hh          , Hh          , Hh          , Hh          , Hh          , Hh          , Hh          , Gg          , Gg          , Gg          , Gg          , Gg          , Hh          , Gg          , Mm          , Mm          
Gg          , Gg          , Hh          , Hh          , Hh          , Mm          , Hh          , Hh          , Gs^Fp       , Gg          , Gs^Fp       , Gs^Fp       , Gs^Fp       , Gs^Fp       , Gg          , Gs^Fp       , Hh          , Hh          , Mm          , Mm          , Mm          , Mm          , Hh          , Mm          , Mm          , Hh          , Mm          , Mm          , Hh          , Hh          , Hh          , Gg          , Gg          , Gg          , Hh          , Hh          , Mm          , Mm          
Gg          , Gg          , Hh          , Hh          , Gs^Fp       , Hh          , Hh          , Gs^Fp       , Gg          , Gs^Fp       , Gs^Fp       , Gs^Fp       , Gg          , Gs^Fp       , Gg          , Gg          , Hh          , Hh          , Hh          , Mm          , Hh          , Hh          , Hh          , Mm          , Hh          , Mm          , Mm          , Mm          , Gg          , Hh          , Gg          , Gg          , Gs^Fp       , Hh          , Mm          , Mm          , Mm          , Ww          
Gg          , Gg          , Hh          , Hh          , Gs^Fp       , Gs^Fp       , Gg          , Gg          , Gg          , Gg          , Gg          , Gg          , Gg^Vh       , Gg          , Gg          , Gg          , Hh          , Mm          , Hh          , Hh          , Hh          , Hh          , Hh          , Hh          , Gs^Fp       , Hh          , Hh          , Hh          , Hh          , Hh          , Gg          , Gg          , Gs^Fp       , Hh          , Hh          , Mm          , Mm          , Mm          
Gg          , Hh          , Gg          , Gg          , Gg          , Gs^Fp       , Gg          , Gg          , Gg          , Gg          , Gs^Fp       , Gg          , Gg          , Gg          , Gg          , Gg          , Hh          , Hh          , Hh          , Hh          , Hh          , Gs^Fp       , Gs^Fp       , Hh          , Gs^Fp       , Hh          , Gg          , Hh          , Gg          , Gg          , Gg          , Gg^Ve       , Gs^Fp       , Hh          , Gs^Fp       , Mm          , Gg          , Hh          
Gg          , Gg          , Gg          , Gg          , Gg          , Gg          , Gg          , Hh          , Gg          , Gs^Fp       , Gs^Fp       , Gg          , Gg          , Gg          , Gg          , Gg          , Gs^Fp       , Hh          , Hh          , Hh          , Hh          , Gs^Fp       , Gs^Fp       , Gs^Fp       , Gg          , Gg          , Gg          , Gg          , Gs^Fp       , Gg          , Gs^Fp       , Gs^Fp       , Gg          , Gs^Fp       , Gs^Fp       , Hh          , Gg          , Gg          
Gg          , Gg          , Gg          , Gs^Fp       , Gs^Fp       , Gs^Fp       , Gg          , Gg          , Gg          , Gs^Fp       , Gs^Fp       , Gs^Fp       , Gs^Fp       , Gg          , Gg          , Gg^Vh       , Hh          , Hh          , Hh          , Hh          , Gg          , Gs^Fp       , Gg^Ve       , Gs^Fp       , Gg          , Gg          , Gg          , Gs^Fp       , Gs^Fp       , Gg          , Gg          , Gg          , Gg          , Gg          , Gg          , Gg          , Ss          , Gg          
Gg          , Gg          , Gs^Fp       , Gg          , Gs^Fp       , Gs^Fp       , Gs^Fp       , Gg          , Gg          , Gg          , Gg^Ve       , Gg          , Gg          , Gs^Fp       , Gg          , Gg          , Gs^Fp       , Hh          , Hh          , Hh          , Gg          , Gs^Fp       , Gs^Fp       , Gs^Fp       , Gg          , Gg          , Gg          , Gs^Fp       , Gs^Fp       , Gs^Fp       , Gg          , Gg          , Gg          , Gs^Fp       , Gs^Fp       , Gs^Fp       , Ss          , Gg          
Gg          , Gs^Fp       , Gg^Ve       , Gg          , Gg          , Gs^Fp       , Gs^Fp       , Gs^Fp       , Gs^Fp       , Gs^Fp       , Gs^Fp       , Gs^Fp       , Gg          , Gg          , Gg          , Gg          , Gg          , Hh          , Gg          , Gg          , Gg          , Gs^Fp       , Gg          , Gs^Fp       , Gs^Fp       , Gg          , Gs^Fp       , Gg          , Gg          , Gs^Fp       , Gg          , Gg          , Ds          , Gg          , Ds          , Gs^Fp       , Ww          , Gg^Vh       
Gg          , Gs^Fp       , Gg          , Gs^Fp       , Gg          , Gg          , Gg          , Gs^Fp       , Gs^Fp       , Gs^Fp       , Gs^Fp       , Gs^Fp       , Gg          , Gg          , Gg          , Gg          , Gg          , Hh          , Gg          , Gg          , Gg          , Gg          , Gg          , Gg          , Gs^Fp       , Gs^Fp       , Gs^Fp       , Gg          , Gs^Fp       , Gg          , Gg          , Gg          , Ds          , Gg          , Ds          , Ds          , Ww          , Ww          
Hh          , Gs^Fp       , Gg          , Gg          , Gg          , Gg          , Gg          , Gg          , Gg          , Gs^Fp       , Gg          , Gg          , Gg          , Gg          , Gg          , Gg          , Gg          , Gs^Fp       , Gg          , Gg          , Gg          , Gg          , Gg          , Gs^Fp       , Gg          , Gg          , Gg          , Gs^Fp       , Gg          , Gs^Fp       , Gs^Fp       , Gg          , Ww          , Ds          , Ww          , Ww          , Gg          , Ds          
Hh          , Gg          , Gg          , Gg          , Ww          , Gg          , Gg          , Gg          , Gg          , Gg          , Gs^Fp       , Gg          , Gg          , Gg          , Gg          , Gg          , Gg^Vh       , Gg          , Gs^Fp       , Gg          , Gs^Fp       , Gg          , Gg          , Gg          , Gg          , Gg          , Gg          , Gg          , Gg          , Gg^Ve       , Gs^Fp       , Gs^Fp       , Ww          , Ww          , Ds          , Ds          , Gg          , Gg          
Hh          , Gg          , Gg          , Ww          , Ww          , Ww          , Ww          , Gg          , Gg          , Gs^Fp       , Gg          , Gs^Fp       , Gg          , Gg          , Gg          , Gg          , Gg          , Gg          , Gg          , Gs^Fp       , Ds          , Gs^Fp       , Ss          , Gg          , Ss          , Gg          , Gg          , Gg          , Gg          , Gs^Fp       , Gs^Fp       , Gg          , Ww          , Ds          , Gs^Fp       , Gg          , Gg          , Gg          
Gg          , Gg          , Gg          , Ww          , Ww          , Ww          , Ww          , Gg          , Gg          , Gg          , Gg          , Gg          , Gg          , Gg          , Ds          , Gg          , Gg          , Gg          , Gg          , Gg          , Gg          , Gs^Fp       , Gs^Fp       , Ss          , Ss          , Gg          , Gg          , Gg          , Gg          , Gg          , Gs^Fp       , Gs^Fp       , Gs^Fp       , Gs^Fp       , Gg          , Gg          , Gg^Vh       , Gg          
Gg          , Gg          , Gg          , Ww          , Ww          , Ww          , Gg          , Gg          , Gg          , Gg          , Gg^Ve       , Gs^Fp       , Gg          , Gg          , Gg          , Gg          , Gs^Fp       , Hh          , Hh          , Hh          , Hh          , Ds          , Gg          , Gs^Fp       , Gs^Fp       , Gg          , Gg          , Gg          , Gs^Fp       , Gg          , Gs^Fp       , Gs^Fp       , Gg          , Ww          , Gg          , Ds          , Ww          , Hh          
Gs^Fp       , Gg          , Gs^Fp       , Gg          , Ww          , Ww          , Ww          , Gg          , Gg          , Gs^Fp       , Gs^Fp       , Gs^Fp       , Hh          , Gg          , Mm          , Gs^Fp       , Mm          , Hh          , Hh          , Hh          , Mm          , Hh          , Gg          , Gg^Ve       , Gg          , Ss          , Gs^Fp       , Gs^Fp       , Gs^Fp       , Gg          , Gg          , Gg          , Gg          , Ww          , Gg          , Gg          , Ww          , Ww          
Gg          , Gs^Fp       , Gs^Fp       , Gg          , Gg          , Ww          , Ww          , Ww          , Gg          , Gg          , Ch          , Gs^Fp       , Hh          , Hh          , Mm^Xm       , Mm^Xm       , Xu          , Uu          , Cud         , Uu          , Xu          , Mm^Xm       , Mm^Xm       , Gg          , Gg          , Gs^Fp       , Ch          , Gs^Fp       , Gg          , Gs^Fp       , Gg          , Gg          , Gg          , Ww          , Ww          , Gg          , Ww          , Ww          
Gg          , Gg          , Gg          , Gs^Fp       , Gs^Fp       , Gg          , Ww          , Gg          , Hh          , Ch          , Ch          , Ch          , Hh          , Mm          , Mm^Xm       , Mm^Xm       , Xu          , Cud         , 3 Kud       , Cud         , Xu          , Mm^Xm       , Mm^Xm       , Hh          , Hh          , Ch          , Ch          , Ch          , Gg          , Gg          , Gg          , Gg          , Ww          , Ww          , Ww          , Ww          , Ww          , Ww          
Gs^Fp       , Gg          , Gg          , Gg^Ve       , Gs^Fp       , Gg          , Hh          , Hh          , Hh          , Ch          , Ch          , 1 Kh        , Mm          , Mm          , Mm^Xm       , Mm^Xm       , Xu          , Cud         , Cud         , Cud         , Xu          , Mm          , Mm^Xm       , Hh          , Hh          , 2 Kh        , Ch          , Ch          , Gg          , Gg          , Gg          , Gg          , Ww          , Ww          , Ww          , Ww          , Ww          , Ww          
Gs^Fp       , Gg          , Gs^Fp       , Gs^Fp       , Hh          , Gg          , Hh          , Hh          , Hh          , Mm          , Mm^Xm       , Mm^Xm       , Mm^Xm       , Mm^Xm       , Mm          , Mm          , Mm          , Xu          , Xu          , Xu          , Mm          , Mm          , Mm          , Mm^Xm       , Hh          , Gg          , Gs^Fp       , Gs^Fp       , Gg          , Gg          , Gg          , Ww          , Ww          , Gg          , Ww          , Ww          , Hh          , Ww          
Gg          , Gs^Fp       , Hh          , Hh          , Hh          , Hh          , Hh          , Hh          , Mm          , Hh          , Mm^Xm       , Mm^Xm       , Mm          , Mm          , Mm          , Mm          , Mm          , Mm          , Mm          , Mm          , Mm          , Mm          , Mm          , Mm^Xm       , Hh          , Gs^Fp       , Gs^Fp       , Gs^Fp       , Gg          , Gg          , Gg          , Gs^Fp       , Gs^Fp       , Ww          , Gg          , Ww          , Hh          , Mm          
Gg          , Hh          , Mm          , Hh          , Mm          , Hh^Vhh      , Mm^Xm       , Mm          , Mm^Xm       , Mm^Xm       , Mm^Xm       , Mm^Xm       , Mm          , Mm          , Mm          , Mm          , Mm          , Mm          , Mm          , Mm          , Mm          , Mm          , Mm          , Mm^Xm       , Mm          , Gs^Fp       , Gs^Fp       , Gs^Fp       , Gg          , Gg          , Gg          , Gg          , Gs^Fp       , Ww          , Hh          , Ds          , Hh          , Mm          
Gg          , Hh          , Mm          , Mm          , Mm^Xm       , Mm^Xm       , Mm^Xm       , Mm^Xm       , Mm          , Mm          , Mm          , Mm          , Mm          , Mm          , Mm          , Mm          , Mm          , Mm          , Mm          , Mm          , Mm          , Mm          , Mm          , Mm^Xm       , Mm          , Mm          , Hh          , Hh          , Ss          , Gg          , Hh          , Gg          , Gs^Fp       , Gg^Vh       , Hh          , Hh          , Mm          , Mm^Xm       
Gg          , Hh          , Mm^Xm       , Mm^Xm       , Mm          , Mm^Xm       , Mm          , Mm          , Mm          , Mm          , Mm          , Mm          , Mm          , Mm          , Mm          , Mm          , Mm          , Mm          , Mm          , Mm          , Mm          , Mm          , Mm          , Mm^Xm       , Mm^Xm       , Hh          , Mm^Xm       , Hh          , Hh          , Hh          , Mm          , Hh          , Gg          , Gg          , Hh          , Mm          , Mm          , Mm^Xm       
Mm^Xm       , Mm^Xm       , Mm          , Mm          , Mm          , Mm          , Mm          , Mm          , Mm          , Mm          , Mm          , Mm          , Mm          , Mm          , Mm          , Mm          , Mm          , Mm          , Mm          , Mm          , Mm          , Mm          , Mm          , Mm^Xm       , Mm          , Mm^Xm       , Mm          , Mm^Xm       , Mm^Xm       , Hh          , Mm          , Mm          , Hh          , Hh          , Mm^Xm       , Mm^Xm       , Mm^Xm       , Mm^Xm       
Mm^Xm       , Mm          , Mm          , Mm          , Mm          , Mm          , Mm          , Mm          , Mm          , Mm          , Mm          , Mm          , Mm          , Mm          , Mm          , Mm          , Mm          , Mm          , Mm          , Mm          , Mm          , Mm          , Mm          , Mm          , Mm          , Mm          , Mm          , Mm          , Mm          , Mm^Xm       , Mm^Xm       , Mm          , Mm^Xm       , Mm^Xm       , Mm^Xm       , Mm^Xm       , Mm          , Mm          
Mm          , Mm          , Mm          , Mm          , Mm          , Mm          , Mm          , Mm          , Mm          , Mm          , Mm          , Mm          , Mm          , Mm          , Mm          , Mm          , Mm          , Mm          , Mm          , Mm          , Mm          , Mm          , Mm          , Mm          , Mm          , Mm          , Mm          , Mm          , Mm          , Mm          , Mm          , Mm          , Mm          , Mm          , Mm          , Mm          , Mm          , Mm          
