border_size=1
usage=map

Gg          , Gg          , Gg          , Gg          , Gg          , Gg          , Gg          , Gg          , Gg          , Gg          , Gg          , Gg          , Gg          , Gg          , Gg          , Gg          , Gg          , Gg          , Gg          , Gg          , Gg          , Gg          , Gg          , Gg          , Gg          , Gg          , Gg          , Gg          , Gg          , Gg          , Gg          , Gg          , Gg          , Gg          , Gg          , Gg          , Gg          , Gg          , Gg          , Gg          , Gg          , Gg          , Gg          , Gg          , Gg          , Gg          
Gg          , Gg          , Gg          , Gg          , Gg          , Gg          , Gg          , Gg          , Gg          , Gg          , Gg          , Gg          , Gg          , Gg          , Gg          , Gg          , Gg          , Gg          , Xos         , Xos         , Xos         , Ur^Ii       , Ur^Ii       , Ur^Ii       , Ur^Ii       , Ur^Ii       , Xos         , Xos         , Xos         , Gg          , Gg          , Gg          , Gg          , Gg          , Gg          , Gg          , Gg          , Gg          , Gg          , Gg          , Gg          , Gg          , Gg          , Gg          , Gg          , Gg          
Gg          , Gg          , Gg          , Gg          , Gg          , Gg          , Gg          , Gg          , Gg          , Gg          , Gg          , Gg          , Gg          , Gg          , Gg          , Gg          , Gg          , Gg          , Xos         , Xos         , Ur          , Ur^Ii       , Ur^Ii       , 1 Ur^Ii     , Ur^Ii       , Ur^Ii       , Ur^Ii       , Xos         , Xos         , Gg          , Gg          , Gg          , Gg          , Gg          , Gg          , Gg          , Gg          , Gg          , Gg          , Gg          , Gg          , Gg          , Gg          , Gg          , Gg          , Gg          
Gg          , Gg          , Gg          , Gg          , Gg          , Gg          , Gg          , Gg          , Gg          , Gg          , Gg          , Gg          , Gg          , Gg          , Gg          , Gg          , Gg          , Xos         , Qxu^Xo      , Ur          , Ur          , Ur          , Ur          , 8 Kud       , Ur          , Ur          , Ur          , Ur          , Qxu^Xo      , Xos         , Gg          , Gg          , Gg          , Gg          , Gg          , Gg          , Gg          , Gg          , Gg          , Gg          , Gg          , Gg          , Gg          , Gg          , Gg          , Gg          
Gg          , Gg          , Gg          , Gg          , Gg          , Gg          , Gg          , Gg          , Gg          , Gg          , Gg          , Gg          , Gg          , Gg          , Gg          , Gg          , Gg          , Xos         , Qxu^Xo      , Qxu^Xo      , Qxu^Xo      , Ur          , Ur          , Ur          , Ur          , Ur          , Qxu^Xo      , Qxu^Xo      , Qxu^Xo      , Xos         , Gg          , Gg          , Gg          , Gg          , Gg          , Gg          , Gg          , Gg          , Gg          , Gg          , Gg          , Gg          , Gg          , Gg          , Gg          , Gg          
Gg          , Gg          , Gg          , Gg          , Gg          , Gg          , Gg          , Gg          , Gg          , Gg          , Gg          , Gg          , Gg          , Gg          , Gg          , Gg          , Gg          , Xos         , Uu          , Qxu^Xo      , Qxu^Xo      , Qxu^Xo      , Qxu^Xo      , Ur          , Qxu^Xo      , Qxu^Xo      , Qxu^Xo      , Qxu^Xo      , Uu          , Xos         , Gg          , Gg          , Gg          , Gg          , Gg          , Gg          , Gg          , Gg          , Gg          , Gg          , Gg          , Gg          , Gg          , Gg          , Gg          , Gg          
Gg          , Gg          , Gg          , Gg          , Gg          , Gg          , Gg          , Gg          , Gg          , Gg          , Gg          , Gg          , Gg          , Gg          , Gg          , Gg          , Gg          , Xos         , Uu          , Uu          , Uu          , Qxu^Xo      , Qxu^Xo      , Qxu^Xo      , Qxu^Xo      , Qxu^Xo      , Uu          , Uu          , Uu          , Xos         , Gg          , Gg          , Gg          , Gg          , Gg          , Gg          , Gg          , Gg          , Gg          , Gg          , Gg          , Gg          , Gg          , Gg          , Gg          , Gg          
Xos         , Xos         , Xos         , Xos         , Xos         , Gg          , Gg          , Gg          , Gg          , Gg          , Gg          , Gg          , Gg          , Gg          , Gg          , Gg          , Gg          , Xos         , Xos         , Uu          , Uu          , Uu          , Uu          , Qxu^Xo      , Uu          , Uu          , Uu          , Uu          , Xos         , Xos         , Gg          , Gg          , Gg          , Gg          , Gg          , Gg          , Gg          , Gg          , Gg          , Gg          , Gg          , Gg          , Xos         , Xos         , Xos         , Xos         
Xos         , Xos         , Uu          , Xos         , Xos         , Xos         , Xos         , Gg          , Gg          , Gg          , Gg          , Gg          , Gg          , Gg          , Gg          , Gg          , Gg          , Xos         , Dd          , Xos         , Xos         , Uu          , Uu          , Uu          , Uu          , Uu          , Xos         , Xos         , Uu          , Xos         , Gg          , Gg          , Gg          , Gg          , Gg          , Gg          , Gg          , Gg          , Gg          , Gg          , Xos         , Xos         , Xos         , Xos         , Xos         , Xos         
Xos         , Xos         , Uu          , Uu          , Xos         , Ss^Bw\      , Ss^Bw|      , Xos         , Xos         , Gg          , Gg          , Gg          , Gg          , Gg          , Gg          , Gg          , Gg          , Xos         , Dd          , Dd^Dr       , Rd          , Xos         , Xos         , Uu          , Xos         , Xos         , Uh          , Ur          , Uu          , Xos         , Gg          , Gg          , Gg          , Gg          , Gg          , Gg          , Gg          , Gg          , Xos         , Xos         , Gg          , Xos         , Uu          , Uu          , Xos         , Xos         
Xos         , Xos         , Uu          , Uu          , Xos         , Ss          , Ss^Bw|      , Ss          , Xos         , Gg          , Gg          , Gg          , Gg          , Gg          , Gg          , Gg          , Gg          , Xos         , Dd          , Dd          , Rd          , Dd          , Dd          , Xos         , Uu          , Uu          , Uh          , Ur          , Uu          , Xos         , Gg          , Gg          , Gg          , Gg          , Gg          , Gg          , Gg          , Gg          , Xos         , Gg          , Gg          , Xos         , Uu          , Uu          , Xos         , Xos         
Xos         , Uu          , Uu          , Uu          , Xos         , Ss          , Ss^Bw|      , Ss          , Xos         , Gg          , Gg          , Gg          , Gg          , Gg          , Gg          , Gg          , Gg          , Xos         , Dd          , Dd          , Rd          , Dd          , Dd          , Ds          , Uu          , Uu          , Uu^Uf       , Ur          , Uu          , Xos         , Gg          , Gg          , Gg          , Gg          , Gg          , Gg          , Gg          , Gg          , Xos         , Gg          , Mm          , Xos         , Uu          , Uu          , Xos         , Xos         
Xos         , Uu          , Uu          , Xos         , Ss^Bw\      , Ss          , Ss^Bw|      , Ss          , Ss          , Xos         , Xos         , Gg          , Gg          , Gg          , Gg          , Gg          , Gg          , Xos         , Dd          , Dd^Do       , Rd          , Dd          , Dd          , Ds          , Uu          , Uu          , Uu          , Ur          , Uu^Uf       , Xos         , Gg          , Gg          , Gg          , Gg          , Gg          , Gg          , Xos         , Xos         , Gg          , Gg          , Gg          , Xos         , Xos         , Uu          , Uu          , Xos         
Xos         , Uu          , Uu          , Xos         , Ss          , Ss^Bw\      , Ss^Bw\      , Ss          , Ss          , Chs         , Ss          , Xos         , Xos         , Gg          , Gg          , Gg          , Gg          , Xos         , Dd          , Dd          , Rd          , Dd          , Dd          , Ds^Dr       , Uu          , Uh          , Ur          , Ur          , Uu          , Xos         , Gg          , Gg          , Gg          , Gg          , Gg          , Xos         , Gg          , Gg          , Gg          , Hh          , Mm          , Gg          , Xos         , Uu          , Uu          , Xos         
Xos         , Uu          , Uu          , Xos         , Ai          , Ss          , Ss          , Ss^Bw\      , Ss^Bw\      , Ss          , Ss          , Xos         , Xos         , Gg          , Gg          , Gg          , Gg          , Xos         , Dd          , Hd          , Rd          , Md          , Dd          , Ds          , Uu          , Uu^Uf       , Ur          , Uh          , Uu          , Xos         , Gg          , Gg          , Gg          , Gg          , Xos         , Xos         , Hh          , Mm          , Mm          , Mm          , Gg          , Hh^Fds      , Xos         , Uu          , Uu          , Xos         
Xos         , Uu          , Uu          , Xos         , Rr          , Ai          , Ai          , Ss          , Ss          , Ss^Bw\      , Ss^Bw\      , Xos         , Xos         , Xos         , Xos         , Gg          , Xos         , Xos         , Dd          , Rd          , Dd          , Dd          , Dd          , Ds          , Uu          , Uu          , Ur          , Uu          , Uu          , Xos         , Xos         , Gg          , Xos         , Xos         , Xos         , Xos         , Gg          , Gg          , Gg          , Mm          , Hh^Fds      , Gg          , Xos         , Uu          , Uu          , Xos         
Xos         , Uu          , Uu          , Xos         , Rr          , Ms          , Aa^Fpa      , Ai          , Ss          , Ss          , Chs         , Ss^Bw\      , Ss^Bw|      , Xos         , Xos         , Xos         , Xos         , Xos         , Dd          , Rd          , Dd          , Dd          , Dd^Dr       , Ds          , Uu          , Uu          , Ur          , Uu          , Uu^Uf       , Xos         , Xos         , Xos         , Xos         , Xos         , Gg          , Gg          , Mm          , Mm          , Hh          , Gg          , Gg          , Gg          , Xos         , Uu          , Xos         , Xos         
Xos         , Xos         , Xos         , Xos         , Rr          , Aa^Fpa      , Aa          , Ai          , Ss          , Ss          , Ss          , Ss          , Ss^Bw|      , Ss          , Xos         , Xos         , Xos         , Xos         , Dd          , Rd          , Rd          , Hd          , Dd          , Ds          , Uu          , Uu          , Ur          , Uh          , Uu          , Xos         , Xos         , Xos         , Xos         , Gg          , Mm          , Gg          , Mm          , Gg          , Gg          , Hh^Fds      , Gg          , Hh^Fds      , Xos         , Xos         , Xos         , Xos         
Xos         , Xos         , Xos         , Xos         , Aa^Fpa      , Rr          , Aa^Fpa      , Ai          , Ai          , Ss          , Ss          , Ss          , Ss^Bw|      , Ss          , Xos         , Xos         , Xos         , Xos         , Dd          , Md          , Rd          , Dd          , Dd          , Ds          , Uu          , Uh          , Uu          , Ur          , Uu          , Xos         , Xos         , Xos         , Xos         , Gg          , Hh          , Mm          , Gg          , Hh          , Gg          , Gg          , Gs^Fp       , Gg          , Xos         , Xos         , Ww          , Xos         
Xos         , Xos         , Xos         , Xos         , Ms          , Rr          , Rr          , Aa          , Aa          , Ai          , Ai          , Ss          , Ss^Bw|      , Ss          , Ss          , Xos         , Xos         , Xos         , Cud         , Rd          , Dd          , Dd          , Dd          , Ds          , Uu          , Uu^Uf       , Uh          , Ur          , Cud         , Xos         , Xos         , Xos         , Mm          , Gg          , Hh          , Mm          , Gg          , Hh^Fds      , Gg          , Gs^Fp       , Gs^Fp       , Gs^Fp       , Xos         , Xos         , Ww          , Wo          
Uu          , Uu          , Uu          , Xos         , Xos         , Aa^Fpa      , Rr          , Ms          , Aa          , Ms          , Ai          , Ss          , Ss^Bw\      , Ss          , Ss          , Cud         , Ss          , Xos         , Dd          , Rd          , Rd          , Dd          , Dd^Dr       , Ds          , Uu          , Uu          , Ur          , Ur          , Uu          , Xos         , Gg          , Cud         , Gg          , Gg          , Mm          , Gg          , Gg          , Gg          , Gg          , Gg          , Gg          , Gs^Fp       , Xos         , Xos         , Ww          , Wo          
Ww          , Ww          , Uu          , Xos         , Xos         , Xos         , Xos         , Rr          , Rr          , Aa^Fpa      , Ai          , Ss          , Ss          , Ss^Bw\      , Ss^Bw\      , Ss          , Ss          , Xos         , Xos         , Dd          , Dd          , Rd          , Rd          , Ds          , Ur          , Ur          , Uu          , Uu          , Xos         , Xos         , Gg          , Hh          , Gg          , Mm          , Hh^Fds      , Gg          , Gg          , Hh^Fds      , Gs^Fp       , Gs^Fp       , Xos         , Xos         , Ww          , Ww          , Wo          , Wo          
Wo          , Ww          , Ww          , Uu          , Uu          , Xos         , Xos         , Aa          , Rr          , Aa^Fpa      , Aa          , Ai          , Ai          , Ss          , Ss          , Ss^Bw\      , Ss^Bw\      , Xos         , Xos         , Xos         , Xos         , Dd          , Rd          , Ds          , Ur          , Uh          , Xos         , Xos         , Xos         , Xos         , Gg          , Mm          , Hh          , Gg          , Hh^Fds      , Gg          , Gs^Fp       , Gg          , Gs^Fp       , Gs^Fp       , Xos         , Xos         , Ww          , Wo          , Wo          , Wo          
Wo          , Wo          , Wo          , Ww          , Uu          , Xos         , Xos         , Ms          , Aa^Fpa      , Rr          , Rr          , Aa^Fpa      , Ms          , Ai          , Ss          , Ss          , Ss^Bw|      , Ss          , Ss          , Xos         , Xos         , Dd          , Rd          , Ds          , Ur          , Uu^Uf       , Xos         , Xos         , Gg          , Gg          , Hh          , Mm          , Gg          , Gg          , Gg          , Gg          , Gg          , Gs^Fp       , Gs^Fp       , Gs^Fp       , Xos         , Xos         , Ww          , Ww          , Ww          , Wo          
Wo          , Wo          , Wo          , Ww          , Ww          , Uu          , Xos         , Xos         , Xos         , Aa^Fpa      , Aa^Fpa      , Rr          , Aa^Fpa      , Ai          , Ss          , Ss          , Cud         , Ss          , Ss          , Ss          , Xos         , Cud         , Dd          , Ds          , Ur          , Cud         , Xos         , Gg          , Gg          , Gg          , Cud         , Gg          , Gg          , Hh^Fds      , Gg          , Gs^Fp       , Gs^Fp       , Gg          , Xos         , Xos         , Ww          , Ww          , Uu          , Uu          , Ww          , Wo          
Wo          , Wo          , Wo          , Wo          , Ww          , Uu          , Uu          , Xos         , Xos         , Xos         , Aa          , Rr          , Rr          , Ai          , Ai          , Ss          , Ss          , Ss^Bw\      , Ss^Bw\      , Ss          , Xos         , Dd          , Dd          , Ds          , Ur          , Uu^Emf      , Xos         , Gg          , Gg          , Gg          , Gg          , Hh^Fds      , Gg          , Gg          , Gs^Fp       , Gg          , Gs^Fp       , Xos         , Xos         , Ww          , Ww          , Ww          , Uu          , Uu          , Ww          , Wo          
Wo          , Wo          , Wo          , Wo          , Wo          , Ww          , Ww          , Uu          , Xos         , Xos         , Ms          , Aa          , Aa          , Cud         , Aa          , Ai          , Ai          , Ss          , Ss          , Ss^Bw|      , Ss          , Dd          , Ur          , Ds          , Ur          , Ds          , Rb          , Gg          , Gg          , Gg          , Gg          , Gg          , Gg          , Cud         , Gs^Fp       , Gs^Fp       , Gs^Fp       , Xos         , Ww          , Ww          , Uu          , Uu          , Uu          , Uu          , Ww          , Wo          
Wo          , Wo          , Wo          , Wo          , Wo          , Ww          , Uu          , Uu          , Xos         , Xos         , Xos         , Aa          , Aa^Fpa      , Rr          , Rr          , Aa^Fpa      , Ms          , Ai          , Ai          , Ss^Bw\      , Ur          , Ur          , Ur          , Ur          , Ur          , Ur          , Ur          , Gg          , Gg          , Gg          , Gg          , Gg          , Gg          , Gg          , Gg          , Gs^Fp       , Xos         , Xos         , Ww          , Ww          , Uu          , Uu          , Uu          , Uu          , Ww          , Wo          
Wo          , Wo          , Wo          , Wo          , Ww          , Ww          , Ww          , Uu          , Uu          , Xos         , Xos         , Xos         , Xos         , Aa^Fpa      , Aa          , Rr          , Rr          , Ms          , Ur          , Ur          , Ur          , Ur          , 7 Cud       , 2 Cud       , 3 Cud       , Ur          , Ur          , Ur          , Ur          , Gg          , Gg          , Gg          , Gg          , Gg          , Xos         , Xos         , Ww          , Ww          , Ww          , Uu          , Uu          , Uu          , Uu          , Uu          , Ww          , Wo          
Wo          , Wo          , Wo          , Wo          , Ww          , Ww          , Uu          , Uu          , Uu          , Uu          , Xos         , Xos         , Xos         , Ms          , Ha^Fpa      , Aa          , Ur          , Ur          , Ur          , Ur          , Ur          , Ur          , 6 Cud       , Cud         , 4 Cud       , Ur          , Ur          , Ur          , Ur          , Ur          , Ur          , Gg          , Gg          , Gg          , Xos         , Xos         , Ww          , Wo          , Wo          , Ww          , Uu          , Uu          , Ww          , Ww          , Wo          , Wo          
Wo          , Wo          , Wo          , Wo          , Wo          , Ww          , Ww          , Uu          , Ww          , Uu          , Uu          , Xos         , Xos         , Ms          , Ur          , Ur          , Ur          , Ur          , Ur          , Ur          , Ur          , Ur          , Ur          , 5 Cud       , Ur          , Ur          , Ur          , Ur          , Ur          , Ur          , Ur          , Ur          , Ur          , Gg          , Xos         , Xos         , Ww          , Wo          , Wo          , Ww          , Uu          , Uu          , Ww          , Wo          , Wo          , Wo          
Wo          , Wo          , Wo          , Wo          , Wo          , Wo          , Wo          , Ww          , Uu          , Uu          , Xos         , Xos         , Xos         , Xos         , Xos         , Ur          , Ur          , Ur          , Ur          , Ur          , Ur          , Ur          , Ur          , Ur          , Ur          , Ur          , Ur          , Ur          , Ur          , Ur          , Ur          , Ur          , Xos         , Xos         , Xos         , Xos         , Ww          , Wo          , Ww          , Ww          , Uu          , Uu          , Ww          , Wo          , Wo          , Wo          
Wo          , Wo          , Wo          , Wo          , Wo          , Wo          , Wo          , Ww          , Ww          , Uu          , Uu          , Xos         , Xos         , Xos         , Xos         , Xos         , Xos         , Xos         , Xos         , Xos         , Xos         , Xos         , Xos         , Xos         , Xos         , Xos         , Xos         , Xos         , Xos         , Xos         , Xos         , Xos         , Xos         , Xos         , Xos         , Xos         , Ww          , Wo          , Ww          , Uu          , Uu          , Ww          , Wo          , Wo          , Wo          , Wo          
Wo          , Wo          , Wo          , Wo          , Wo          , Wo          , Wo          , Ww          , Uu          , Uu          , Uu          , Uu          , Uu          , Xos         , Uu          , Xos         , Uu          , Xos         , Uu          , Xos         , Uu          , Xos         , Uu          , Xos         , Uu          , Xos         , Xos         , Xos         , Uu          , Xos         , Uu          , Xos         , Uu          , Uu          , Uu          , Uu          , Uu          , Ww          , Uu          , Uu          , Ww          , Ww          , Wo          , Wo          , Wo          , Wo          
Wo          , Wo          , Wo          , Wo          , Wo          , Wo          , Wo          , Ww          , Uu          , Uu          , Uu          , Uu          , Uu          , Uu          , Uu          , Uu          , Uu          , Uu          , Uu          , Uu          , Uu          , Uu          , Uu          , Uu          , Uu          , Uu          , Uu          , Uu          , Uu          , Uu          , Uu          , Uu          , Uu          , Uu          , Uu          , Uu          , Uu          , Uu          , Uu          , Uu          , Ww          , Wo          , Wo          , Wo          , Wo          , Wo          
