border_size=1
usage=map

Qxe^Xo, Qxe^Xo, Qxe^Xo, Qxe^Xo, Qxe^Xo, Qxe^Xo, Qxe^Xo, Qxe^Xo, Qxe^Xo, Qxe^Xo, Qxe^Xo, Qxe^Xo, Qxe^Xo, Qxe^Xo, Qxe^Xo, Qxe^Xo, Qxe^Xo, Qxe^Xo, Qxe^Xo, Qxe^Xo, Qxe^Xo, Qxe^Xo, Qxe^Xo, Qxe^Xo, Qxe^Xo, Qxe^Xo, Qxe^Xo, Qxe^Xo, Qxe^Xo
Qxe^Xo, Qxe^Xo, Qxe^Xo, Qxe^Xo, Qxe^Xo, Qxe^Xo, Qxe^Xo, Qxe^Xo, Qxe^Xo, Qxe^Xo, Qxe^Xo, Qxe^Xo, Qxe^Xo, Qxe^Xo, Wwg, Qxe^Xo, Qxe^Xo, Qxe^Xo, Qxe^Xo, Qxe^Xo, Qxe^Xo, Qxe^Xo, Qxe^Xo, Qxe^Xo, Qxe^Xo, Qxe^Xo, Qxe^Xo, Qxe^Xo, Qxe^Xo
Qxe^Xo, Qxe^Xo, Qxe^Xo, Qxe^Xo, Qxe^Xo, Qxe^Xo, Qxe^Xo, Qxe^Xo, Qxe^Xo, Qxe^Xo, Qxe^Xo, Qxe^Xo, Gs^Fp, Gg, Wwf, Gg, Mm, Qxe^Xo, Qxe^Xo, Qxe^Xo, Qxe^Xo, Qxe^Xo, Qxe^Xo, Qxe^Xo, Qxe^Xo, Qxe^Xo, Qxe^Xo, Qxe^Xo, Qxe^Xo
Qxe^Xo, Qxe^Xo, Qxe^Xo, Qxe^Xo, Qxe^Xo, Qxe^Xo, Qxe^Xo, Qxe^Xo, Qxe^Xo, Qxe^Xo, Co, Hh, Wwf, Wwf, Gg, Gs^Fp, Gg, Gg, Co, Qxe^Xo, Qxe^Xo, Qxe^Xo, Qxe^Xo, Qxe^Xo, Qxe^Xo, Qxe^Xo, Qxe^Xo, Qxe^Xo, Qxe^Xo
Qxe^Xo, Qxe^Xo, Qxe^Xo, Qxe^Xo, Qxe^Xo, Qxe^Xo, Qxe^Xo, Qxe^Xo, Dd^Do, Co, Gg, Gg, Ss^Vhs, Hh, Gg, Gg, Gg, Gg, Gg, Co, Dd^Do, Qxe^Xo, Qxe^Xo, Qxe^Xo, Qxe^Xo, Qxe^Xo, Qxe^Xo, Qxe^Xo, Qxe^Xo
Qxe^Xo, Qxe^Xo, Qxe^Xo, Qxe^Xo, Qxe^Xo, Qxe^Xo, Qxe^Xo, Qxe^Xo, Co, Gg, Gg, Gs^Fp, Wwf, Gg, Gg, Hh, Gg^Vh, Gg, Gg, Gg, Co, Qxe^Xo, Qxe^Xo, Qxe^Xo, Qxe^Xo, Qxe^Xo, Qxe^Xo, Qxe^Xo, Qxe^Xo
Qxe^Xo, Qxe^Xo, Qxe^Xo, Qxe^Xo, Qxe^Xo, Qxe^Xo, Qxe^Xo, Qxe^Xo, Co, Gg, Gg, Gg, Gg, Wwf, Wwf, Gg, Gg, Gg, Gs^Fp, Gg, Co, Qxe^Xo, Qxe^Xo, Qxe^Xo, Qxe^Xo, Qxe^Xo, Qxe^Xo, Qxe^Xo, Qxe^Xo
Qxe^Xo, Qxe^Xo, Qxe^Xo, Qxe^Xo, Qxe^Xo, Qxe^Xo, Qxe^Xo, Qxe^Xo, Gg, Gg, Gs^Fp, Hh, Hh^Vhh, Gg, Wwf, Gg, Wwf, Gg, Gg, Hh, Gg, Qxe^Xo, Qxe^Xo, Qxe^Xo, Qxe^Xo, Qxe^Xo, Qxe^Xo, Qxe^Xo, Qxe^Xo
Qxe^Xo, Qxe^Xo, Qxe^Xo, Qxe^Xo, Qxe^Xo, Qxe^Xo, Qxe^Xo, Qxe^Xo, Hh, Gg, Gg, Gg, Gg, Gg, Wwf, Wwf, Hh, Wwf, Gg, Gg, Gs^Fp, Qxe^Xo, Qxe^Xo, Qxe^Xo, Qxe^Xo, Qxe^Xo, Qxe^Xo, Qxe^Xo, Qxe^Xo
Qxe^Xo, Qxe^Xo, Qxe^Xo, Qxe^Xo, Qxe^Xo, Qxe^Xo, Qxe^Xo, Qxe^Xo, Gg, Gg, Wwf, Gg, Mm, Wwf, Gg, Gg, Gg, Wwf, Gg, Hh^Vhh, Gg, Qxe^Xo, Qxe^Xo, Qxe^Xo, Qxe^Xo, Qxe^Xo, Qxe^Xo, Qxe^Xo, Qxe^Xo
Qxe^Xo, Qxe^Xo, Qxe^Xo, Qxe^Xo, Qxe^Xo, Qxe^Xo, Qxe^Xo, Qxe^Xo, Wwg, Wwf, Gg^Vh, Wwf, Wwf, Wwf, Hh, Gg^Vh, Gs^Fp, Wwf, Wwf, Wwf, Wwg, Qxe^Xo, Qxe^Xo, Qxe^Xo, Qxe^Xo, Qxe^Xo, Qxe^Xo, Qxe^Xo, Qxe^Xo
Qxe^Xo, Qxe^Xo, Qxe^Xo, Qxe^Xo, Qxe^Xo, Qxe^Xo, Qxe^Xo, Qxe^Xo, Qxe^Xo, Gs^Fp, Hh, Gg, Gg, Gg, Gg, Gg, Gg, Gg, Gg, Mm, Qxe^Xo, Qxe^Xo, Qxe^Xo, Qxe^Xo, Qxe^Xo, Qxe^Xo, Qxe^Xo, Qxe^Xo, Qxe^Xo
Qxe^Xo, Qxe^Xo, Qxe^Xo, Qxe^Xo, Qxe^Xo, Qxe^Xo, Gg, Wwg, Gg, Qxe^Xo, Qxe^Xo, Gg, Chr, Gs^Fp, Gg, Gg, Chr, Gg, Qxe^Xo, Qxe^Xo, Gg, Wwg, Gg, Qxe^Xo, Qxe^Xo, Qxe^Xo, Qxe^Xo, Qxe^Xo, Qxe^Xo
Qxe^Xo, Qxe^Xo, Qxe^Xo, Qxe^Xo, Gg, Gs^Fp, Wwf, Wwf, Gs^Fp, Mm, Gg, Qxe^Xo, Qxe^Xo, Chr, 2 Khr, Chr, Qxe^Xo, Qxe^Xo, Gg, Gs^Fp, Wwf, Wwf, Gs^Fp, Mm, Gg, Qxe^Xo, Qxe^Xo, Qxe^Xo, Qxe^Xo
Qxe^Xo, Qxe^Xo, Co, Co, Gg, Wwf, Hh, Gg, Gg, Gg, Gg, Chr, Chr, Qxe^Xo, Qxe^Xo, Qxe^Xo, Chr, Chr, Gg, Wwf, Hh, Gg, Gg, Gg, Gg, Co, Co, Qxe^Xo, Qxe^Xo
Qxe^Xo, Dd^Do, Gg, Gg, Gs^Fp, Ss^Vhs, Gg, Gg, Gg, Gg, Gg, Gg, Gg, 3 Khr, Qxe^Xo, 4 Khr, Gg, Gg, Gs^Fp, Ss^Vhs, Gg, Gg, Hh, Gg, Gg, Gg, Gg, Dd^Do, Qxe^Xo
Qxe^Xo, Co, Gg, Gg, Gg, Wwf, Wwf, Gg, Gg, Gg^Vh, Gg, Gg, Gg, Chr, Qxe^Xo, Chr, Gg, Gg, Gg, Wwf, Wwf, Gg, Gg, Gg^Vh, Gg, Gg, Gg, Co, Qxe^Xo
Qxe^Xo, Co, Gg, Gg, Hh, Gg, Gg, Wwf, Gg, Gg, Gg, Gs^Fp, Hh, Chr, Qxe^Xo, Chr, Gg, Gg, Hh, Gg, Gg, Wwf, Gg, Gg, Gg, Gs^Fp, Hh, Co, Qxe^Xo
Qxe^Xo, Gg, Gg, Gs^Fp, Gg, Hh^Vhh, Gg, Wwf, Wwf, Wwf, Wwf, Gg, Gg, Gg, Qxe^Xo, Gg, Gg, Gs^Fp, Gg, Hh^Vhh, Gg, Wwf, Wwf, Wwf, Wwf, Gg, Gg, Gg, Qxe^Xo
Qxe^Xo, Hh, Gg, Gg, Gg, Gg, Wwf, Wwf, Gg, Hh, Wwf, Gg, Hh^Vhh, Gs^Fp, Qxe^Xo, Hh, Gg, Gg, Gg, Gg, Wwf, Wwf, Gg, Hh, Wwf, Gg, Hh^Vhh, Gs^Fp, Qxe^Xo
Qxe^Xo, Gg, Wwf, Wwf, Wwf, Mm, Wwf, Gg, Gg^Vh, Gg, Wwf, Gg, Wwf, Gg, Qxe^Xo, Gg, Wwf, Wwf, Wwf, Mm, Wwf, Gg, Gg^Vh, Gg, Wwf, Gg, Wwf, Gg, Qxe^Xo
Qxe^Xo, Wwg, Gs^Fp, Gg^Vh, Gg, Wwf, Gg, Hh, Gg, Gs^Fp, Gg, Wwf, Mm, Wwg, Qxe^Xo, Wwg, Gs^Fp, Gg^Vh, Gg, Wwf, Gg, Hh, Gg, Gs^Fp, Gg, Wwf, Mm, Wwg, Qxe^Xo
Qxe^Xo, Qxe^Xo, Qxe^Xo, Gg, Gg, Gg, Gs^Fp, Gg, Gg, Gg, Gg, Gg, Qxe^Xo, Qxe^Xo, Qxe^Xo, Qxe^Xo, Qxe^Xo, Gg, Gg, Gg, Gs^Fp, Gg, Gg, Gg, Gg, Gg, Qxe^Xo, Qxe^Xo, Qxe^Xo
Qxe^Xo, Qxe^Xo, Qxe^Xo, Qxe^Xo, Qxe^Xo, Co, Co, Gg, Co, Co, Qxe^Xo, Qxe^Xo, Qxe^Xo, Qxe^Xo, Qxe^Xo, Qxe^Xo, Qxe^Xo, Qxe^Xo, Qxe^Xo, Co, Co, Gg, Co, Co, Qxe^Xo, Qxe^Xo, Qxe^Xo, Qxe^Xo, Qxe^Xo
Qxe^Xo, Qxe^Xo, Qxe^Xo, Qxe^Xo, Qxe^Xo, Qxe^Xo, Qxe^Xo, Dd^Do, Qxe^Xo, Qxe^Xo, Qxe^Xo, Qxe^Xo, Qxe^Xo, Qxe^Xo, Qxe^Xo, Qxe^Xo, Qxe^Xo, Qxe^Xo, Qxe^Xo, Qxe^Xo, Qxe^Xo, Dd^Do, Qxe^Xo, Qxe^Xo, Qxe^Xo, Qxe^Xo, Qxe^Xo, Qxe^Xo, Qxe^Xo
Qxe^Xo, Qxe^Xo, Qxe^Xo, Qxe^Xo, Qxe^Xo, Qxe^Xo, Qxe^Xo, Qxe^Xo, Qxe^Xo, Qxe^Xo, Qxe^Xo, Qxe^Xo, Qxe^Xo, Qxe^Xo, Qxe^Xo, Qxe^Xo, Qxe^Xo, Qxe^Xo, Qxe^Xo, Qxe^Xo, Qxe^Xo, Qxe^Xo, Qxe^Xo, Qxe^Xo, Qxe^Xo, Qxe^Xo, Qxe^Xo, Qxe^Xo, Qxe^Xo
