Qxua^Xo, Qxua^Xo, Qxua^Xo, Qxua^Xo, Qxua^Xo, Qxua^Xo, Qxua^Xo, Qxua^Xo, Qxua^Xo, Qxua^Xo, Qxua^Xo, Qxua^Xo, Qxua^Xo, Qxua^Xo, Qxua^Xo, Qxua^Xo, Qxua^Xo, Qxua^Xo, Qxua^Xo, Qxua^Xo, Qxua^Xo, Qxua^Xo, Qxua^Xo, Qxua^Xo, Qxua^Xo, Qxua^Xo, Qxua^Xo, Qxua^Xo, Qxua^Xo
Qxua^Xo, Qxua^Xo, Qxua^Xo, Qxua^Xo, Qxua^Xo, Qxua^Xo, Qxua^Xo, Qxua^Xo, Qxua^Xo, Qxua^Xo, Qxua^Xo, Qxua^Xo, Qxua^Xo, Qxua^Xo, Wwg, Qxua^Xo, Qxua^Xo, Qxua^Xo, Qxua^Xo, Qxua^Xo, Qxua^Xo, Qxua^Xo, Qxua^Xo, Qxua^Xo, Qxua^Xo, Qxua^Xo, Qxua^Xo, Qxua^Xo, Qxua^Xo
Qxua^Xo, Qxua^Xo, Qxua^Xo, Qxua^Xo, Qxua^Xo, Qxua^Xo, Qxua^Xo, Qxua^Xo, Qxua^Xo, Qxua^Xo, Qxua^Xo, Qxua^Xo, Gs^Fp, Gg, Wwf, Gg, Mm, Qxua^Xo, Qxua^Xo, Qxua^Xo, Qxua^Xo, Qxua^Xo, Qxua^Xo, Qxua^Xo, Qxua^Xo, Qxua^Xo, Qxua^Xo, Qxua^Xo, Qxua^Xo
Qxua^Xo, Qxua^Xo, Qxua^Xo, Qxua^Xo, Qxua^Xo, Qxua^Xo, Qxua^Xo, Qxua^Xo, Qxua^Xo, Qxua^Xo, Co^Xo, Hh, Wwf, Wwf, Gg, Gs^Fp, Gg, Gg, Co^Xo, Qxua^Xo, Qxua^Xo, Qxua^Xo, Qxua^Xo, Qxua^Xo, Qxua^Xo, Qxua^Xo, Qxua^Xo, Qxua^Xo, Qxua^Xo
Qxua^Xo, Qxua^Xo, Qxua^Xo, Qxua^Xo, Qxua^Xo, Qxua^Xo, Qxua^Xo, Qxua^Xo, Ker^Xo, Co^Xo, Gg, Gg, Ss^Vhs, Hh, Gg, Gg, Gg, Gg, Gg, Co^Xo, Ker^Xo, Qxua^Xo, Qxua^Xo, Qxua^Xo, Qxua^Xo, Qxua^Xo, Qxua^Xo, Qxua^Xo, Qxua^Xo
Qxua^Xo, Qxua^Xo, Qxua^Xo, Qxua^Xo, Qxua^Xo, Qxua^Xo, Qxua^Xo, Qxua^Xo, Co^Xo, Gd, Gg, Gs^Fp, Wwf, Gg, Gg, Hh, Gg^Vh, Gg, Gg, Gd, Co^Xo, Qxua^Xo, Qxua^Xo, Qxua^Xo, Qxua^Xo, Qxua^Xo, Qxua^Xo, Qxua^Xo, Qxua^Xo
Qxua^Xo, Qxua^Xo, Qxua^Xo, Qxua^Xo, Qxua^Xo, Qxua^Xo, Qxua^Xo, Qxua^Xo, Co^Xo, Gg, Gg, Gg, Gg, Wwf, Wwf, Gg, Gg, Gg, Gs^Fp, Gg, Co^Xo, Qxua^Xo, Qxua^Xo, Qxua^Xo, Qxua^Xo, Qxua^Xo, Qxua^Xo, Qxua^Xo, Qxua^Xo
Qxua^Xo, Qxua^Xo, Qxua^Xo, Qxua^Xo, Qxua^Xo, Qxua^Xo, Qxua^Xo, Qxua^Xo, Gg, Gg, Gs^Fp, Hh, Hh^Vhh, Gg, Wwf, Gg, Wwf, Gg, Gg, Hh, Gg, Qxua^Xo, Qxua^Xo, Qxua^Xo, Qxua^Xo, Qxua^Xo, Qxua^Xo, Qxua^Xo, Qxua^Xo
Qxua^Xo, Qxua^Xo, Qxua^Xo, Qxua^Xo, Qxua^Xo, Qxua^Xo, Qxua^Xo, Qxua^Xo, Hh, Gg, Gg, Gg, Gg, Gg, Wwf, Wwf, Hh, Wwf, Gg, Gg, Gs^Fp, Qxua^Xo, Qxua^Xo, Qxua^Xo, Qxua^Xo, Qxua^Xo, Qxua^Xo, Qxua^Xo, Qxua^Xo
Qxua^Xo, Qxua^Xo, Qxua^Xo, Qxua^Xo, Qxua^Xo, Qxua^Xo, Qxua^Xo, Qxua^Xo, Gg, Gg, Wwf, Gg, Mm, Wwf, Gg, Gg, Gg, Wwf, Gg, Hh^Vhh, Gg, Qxua^Xo, Qxua^Xo, Qxua^Xo, Qxua^Xo, Qxua^Xo, Qxua^Xo, Qxua^Xo, Qxua^Xo
Qxua^Xo, Qxua^Xo, Qxua^Xo, Qxua^Xo, Qxua^Xo, Qxua^Xo, Qxua^Xo, Qxua^Xo, Wwg, Wwf, Gg^Vh, Wwf, Wwf, Wwf, Hh, Gg^Vh, Gs^Fp, Wwf, Wwf, Wwf, Wwg, Qxua^Xo, Qxua^Xo, Qxua^Xo, Qxua^Xo, Qxua^Xo, Qxua^Xo, Qxua^Xo, Qxua^Xo
Qxua^Xo, Qxua^Xo, Qxua^Xo, Qxua^Xo, Qxua^Xo, Qxua^Xo, Qxua^Xo, Qxua^Xo, Qxua^Xo, Gs^Fp, Hh, Gg, Gg, Gg, Gg, Gg, Gg, Gg, Gg, Mm, Qxua^Xo, Qxua^Xo, Qxua^Xo, Qxua^Xo, Qxua^Xo, Qxua^Xo, Qxua^Xo, Qxua^Xo, Qxua^Xo
Qxua^Xo, Qxua^Xo, Qxua^Xo, Qxua^Xo, Qxua^Xo, Qxua^Xo, Gg, Wwg, Gg, Qxua^Xo, Qxua^Xo, Gg, Cud, Gs^Fp, Gg, Gg, Cud, Gg, Qxua^Xo, Qxua^Xo, Gg, Wwg, Gg, Qxua^Xo, Qxua^Xo, Qxua^Xo, Qxua^Xo, Qxua^Xo, Qxua^Xo
Qxua^Xo, Qxua^Xo, Qxua^Xo, Qxua^Xo, Gg, Gs^Fp, Wwf, Wwf, Gs^Fp, Mm, Gg, Qxua^Xo, Qxua^Xo, Cud, 2 Kud, Cud, Qxua^Xo, Qxua^Xo, Gg, Gs^Fp, Wwf, Wwf, Gs^Fp, Mm, Gg, Qxua^Xo, Qxua^Xo, Qxua^Xo, Qxua^Xo
Qxua^Xo, Qxua^Xo, Co^Xo, Co^Xo, Gg, Wwf, Hh, Gg, Gg, Gg, Gg, Cud, Cud, Qxua^Xo, Qxua^Xo, Qxua^Xo, Cud, Cud, Gg, Wwf, Hh, Gg, Gg, Gg, Gg, Co^Xo, Co^Xo, Qxua^Xo, Qxua^Xo
Qxua^Xo, Ker^Xo, Gd, Gg, Gs^Fp, Ss^Vhs, Gg, Gg, Gg, Gg, Gg, Gg, Gg, 3 Kud, Qxua^Xo, 4 Kud, Gg, Gg, Gs^Fp, Ss^Vhs, Gg, Gg, Hh, Gg, Gg, Gg, Gd, Ker^Xo, Qxua^Xo
Qxua^Xo, Co^Xo, Gg, Gg, Gg, Wwf, Wwf, Gg, Gg, Gg^Vh, Gg, Gg, Gg, Cud, Qxua^Xo, Cud, Gg, Gg, Gg, Wwf, Wwf, Gg, Gg, Gg^Vh, Gg, Gg, Gg, Co^Xo, Qxua^Xo
Qxua^Xo, Co^Xo, Gg, Gg, Hh, Gg, Gg, Wwf, Gg, Gg, Gg, Gs^Fp, Hh, Cud, Qxua^Xo, Cud, Gg, Gg, Hh, Gg, Gg, Wwf, Gg, Gg, Gg, Gs^Fp, Hh, Co^Xo, Qxua^Xo
Qxua^Xo, Gg, Gg, Gs^Fp, Gg, Hh^Vhh, Gg, Wwf, Wwf, Wwf, Wwf, Gg, Gg, Gg, Qxua^Xo, Gg, Gg, Gs^Fp, Gg, Hh^Vhh, Gg, Wwf, Wwf, Wwf, Wwf, Gg, Gg, Gg, Qxua^Xo
Qxua^Xo, Hh, Gg, Gg, Gg, Gg, Wwf, Wwf, Gg, Hh, Wwf, Gg, Hh^Vhh, Gs^Fp, Qxua^Xo, Hh, Gg, Gg, Gg, Gg, Wwf, Wwf, Gg, Hh, Wwf, Gg, Hh^Vhh, Gs^Fp, Qxua^Xo
Qxua^Xo, Gg, Wwf, Wwf, Wwf, Mm, Wwf, Gg, Gg^Vh, Gg, Wwf, Gg, Wwf, Gg, Qxua^Xo, Gg, Wwf, Wwf, Wwf, Mm, Wwf, Gg, Gg^Vh, Gg, Wwf, Gg, Wwf, Gg, Qxua^Xo
Qxua^Xo, Wwg, Gs^Fp, Gg^Vh, Gg, Wwf, Gg, Hh, Gg, Gs^Fp, Gg, Wwf, Mm, Wwg, Qxua^Xo, Wwg, Gs^Fp, Gg^Vh, Gg, Wwf, Gg, Hh, Gg, Gs^Fp, Gg, Wwf, Mm, Wwg, Qxua^Xo
Qxua^Xo, Qxua^Xo, Qxua^Xo, Gg, Gg, Gg, Gs^Fp, Gg, Gg, Gg, Gg, Gg, Qxua^Xo, Qxua^Xo, Qxua^Xo, Qxua^Xo, Qxua^Xo, Gg, Gg, Gg, Gs^Fp, Gg, Gg, Gg, Gg, Gg, Qxua^Xo, Qxua^Xo, Qxua^Xo
Qxua^Xo, Qxua^Xo, Qxua^Xo, Qxua^Xo, Qxua^Xo, Co^Xo, Co^Xo, Gd, Co^Xo, Co^Xo, Qxua^Xo, Qxua^Xo, Qxua^Xo, Qxua^Xo, Qxua^Xo, Qxua^Xo, Qxua^Xo, Qxua^Xo, Qxua^Xo, Co^Xo, Co^Xo, Gd, Co^Xo, Co^Xo, Qxua^Xo, Qxua^Xo, Qxua^Xo, Qxua^Xo, Qxua^Xo
Qxua^Xo, Qxua^Xo, Qxua^Xo, Qxua^Xo, Qxua^Xo, Qxua^Xo, Qxua^Xo, Ker^Xo, Qxua^Xo, Qxua^Xo, Qxua^Xo, Qxua^Xo, Qxua^Xo, Qxua^Xo, Qxua^Xo, Qxua^Xo, Qxua^Xo, Qxua^Xo, Qxua^Xo, Qxua^Xo, Qxua^Xo, Ker^Xo, Qxua^Xo, Qxua^Xo, Qxua^Xo, Qxua^Xo, Qxua^Xo, Qxua^Xo, Qxua^Xo
Qxua^Xo, Qxua^Xo, Qxua^Xo, Qxua^Xo, Qxua^Xo, Qxua^Xo, Qxua^Xo, Qxua^Xo, Qxua^Xo, Qxua^Xo, Qxua^Xo, Qxua^Xo, Qxua^Xo, Qxua^Xo, Qxua^Xo, Qxua^Xo, Qxua^Xo, Qxua^Xo, Qxua^Xo, Qxua^Xo, Qxua^Xo, Qxua^Xo, Qxua^Xo, Qxua^Xo, Qxua^Xo, Qxua^Xo, Qxua^Xo, Qxua^Xo, Qxua^Xo
