border_size=1
usage=map

Mm          , Mm          , Hh          , Ds          , Hh          , Hh          , Mm          , Hh          , Hh          , Gg          , Hh          , Hh          , Gg          , Gg          , Gg          , Re          , Re          , Gg          , Gg          , Hh          , Hh          , Hh          , Hh          , Gg          , Hh          , Hh          , Mm          , Mm          , Mm          , Hh          , Hh          , Gg          , Hh          , Hh          , Hh          , Hh          , Gg          , Ww          , Wwr         , Hh          , Hh          , Hh          
Hh          , Hh          , Gg          , Hh          , Hh          , Mm          , Mm          , Mm          , Hh          , Hh          , Gg          , Hh          , Gg          , Gg          , Re          , Re          , Gg          , Gg          , Hh          , Hh          , Hh^Vhh      , Hh          , Gg          , Gg          , Gg          , Hh          , Hh          , Mm          , Mm          , Hh          , Hh          , Hh          , Hh          , Hh          , Gg          , Gg          , Ww          , Ww          , Hh          , Ds          , Hh          , Gg          
Hh          , Hh^Vo       , Gg          , Gg          , Hh          , Mm          , Mm          , Mm          , Hh          , Hh          , Gs^Fp       , Gs^Fp       , Gg          , Gg          , Re          , Gg          , Gs^Fp       , Gs^Fp       , Hh          , Hh          , Hh          , Ds          , Gg          , Gg          , Gs^Fp       , Gs^Fp       , Ds          , Hh          , Hh          , Hh          , Hh          , Gg          , Gg          , Gg          , Ww          , Gg^Vc       , Wwr         , Gg          , Gg          , Hh          , Gg          , Gg          
Mm          , Gg          , Hh          , Gg          , Gg          , Hh          , Hh          , Hh          , Hh          , Gg          , Gg          , Gg          , Re          , Re          , Gg          , Gg          , Gg          , Gs^Fp       , Gg          , Hh          , Gg          , Gg          , Gs^Fp       , Gs^Fp       , Gs^Fp       , Gg          , Gg          , Gg          , Hh          , Mm          , Hh          , Gg          , Gg          , Wwr         , Ww          , Ww          , Ww          , Gg          , Gg          , Gg          , Gg          , Gg          
Mm          , Hh          , Kud         , Cud         , Gg          , Gs^Fp       , Gg          , Hh^Vo       , Gg          , Gg          , Gg          , Re          , Gg          , Gg          , Gg          , Gg          , Hh          , Gg          , Gg          , Gg          , Gg          , Gg          , Hh          , Gs^Fp       , Gg          , Gg          , Gg          , Gg          , Gg          , Hh          , Gg          , Gg          , Chr         , Wwf         , Wwf         , Ww          , Gg          , Gg          , Gg          , Gg^Vc       , Gg          , Gg          
Mm          , Hh          , Re          , Cud         , Gg          , Gg          , Gg          , Gg          , Hh          , Gg          , Gg          , Re          , Gg          , Gg          , Hh^Vhh      , Hh          , Gg          , Gg          , Gg          , Gg          , Gg          , Hh          , Gg          , Gg          , Gg          , Gg          , Gg          , Gg          , Gg          , Gg          , Gg          , Khr         , Re          , Chr         , Gg          , Gg          , Hh          , Gg          , Gg          , Gg          , Hh          , Hh          
Gg          , Gg          , Re          , Gg          , Gg          , Gg          , Hh          , Hh          , Ds          , Gg          , Re          , Re          , Gg          , Hh          , Hh          , Hh          , Gg          , Gg          , Gg          , Gg          , Gg          , Gg          , Gg          , Gg^Vc       , Gg          , Gg          , Re^Gvs      , Gg^Wm       , Re^Gvs      , Re^Gvs      , Re^Gvs      , Re          , Gg          , Gg          , Hh          , Hh          , Hh          , Hh          , Hh          , Gg          , Gg          , Hh          
Hh          , Hh^Vo       , Hh          , Re          , Hh          , Hh          , Mm          , Mm          , Hh          , Re          , Gg          , Gg          , Hh          , Hh          , Gg          , Gg          , Gg          , Gg          , Gg          , Gg          , Re^Gvs      , Re^Gvs      , Re^Gvs      , Gg          , Gg          , Re^Gvs      , Re^Gvs      , Gg          , Re^Gvs      , Re^Gvs      , Re^Gvs      , Re          , Gg          , Gg          , Gg          , Gg^Vc       , Gg          , Hh          , Gg          , Gg          , Gg          , Gg          
Mm          , Mm          , Hh          , Re          , Re          , Mm          , Mm          , Mm          , Hh          , Re          , Gg          , Gs^Fp       , Gs^Fp       , Hh          , Gg          , Gg          , Gs^Fp       , Gs^Fp       , Re          , Gg^Vc       , Re^Gvs      , Re^Gvs      , Re^Gvs      , Re^Gvs      , Gg          , Re^Gvs      , Re^Gvs      , Re^Gvs      , Re^Gvs      , Re^Gvs      , Re          , Re          , Gg          , Gg          , Gg          , Gg          , Gs^Fp       , Gg          , Ds          , Gg          , Gg          , Gg          
Hh          , Hh          , Hh          , Hh          , Re          , Hh          , Hh          , Hh          , Gg          , Re          , Gg          , Gg          , Gg          , Gg          , Hh          , Gs^Fp       , Gs^Fp       , Re          , Re^Gvs      , Re^Gvs      , Re^Gvs      , Re^Gvs      , Re^Gvs      , Re^Gvs      , Gg          , Gg          , Gg          , Gg          , Gg          , Re          , Gg^Vc       , Gg          , Gg          , Gg          , Gg          , Ss          , Ss          , Ds          , Gs^Ft       , Ss          , Gg          , Hh          
Re          , Re          , Re          , Re          , Gg          , Re          , Re          , Hh          , Re          , Re          , Re          , Re          , Re          , Gg          , Gg          , Hh          , Gg          , Re          , Gg          , Re^Gvs      , Gg          , Re^Gvs      , Gg          , Gg          , Gs^Fp       , Gs^Fp       , Gs^Fp       , Gg          , Gg          , Re          , Gg          , Gg          , Gg          , Gg          , Gs^Fp       , Ss          , Ss          , Ss          , Ss          , Ss          , Gg          , Gg          
Mm          , Hh          , Gg          , Gg^Vc       , Gg          , Gg          , Gg          , Re          , Re          , Gg          , Gg          , Gg          , Gg          , Re          , Re          , Gg          , Gg          , Re          , Re          , Gg          , Gg          , Gg          , Gg          , Gs^Fp       , Gs^Fp       , Gg          , Gs^Fp       , Gg          , Gg          , Re          , Gg          , Gg          , Hh          , Gg          , Gg          , Ss          , Gs^Fp       , Ss^Vhs      , Gg          , Gg          , Re          , Gg          
Mm          , Hh          , Gg          , Gg          , Hh          , Gs^Fp       , Hh          , Gg          , Re          , Gs^Fp       , Gg          , Gg^Vc       , Gg          , Gg          , Gg          , Re          , Re          , Re          , Gg          , Re          , Re          , Gg^Vh       , Gg          , Gg          , Gg          , Gg          , Gg          , Gg          , Re          , Re          , Gg          , Gg          , Hh          , Hh          , Hh          , Gg          , Gg          , Gg          , Re          , Re          , Gs          , Re          
Hh          , Hh          , Gs^Fp       , Mm          , Mm          , Hh          , Hh          , Re          , Hh          , Gs^Fp       , Gg          , Gg          , Hh          , Gg          , Gg          , Gg          , Gg          , Gg          , Gs^Fp       , Gg          , Gg          , Re          , Gg          , Gg          , Gg          , Gg          , Re          , Re          , Gg          , Gg          , Gg          , Gg          , Gg          , Gg          , Gg          , Gg          , Gg          , Re          , Gg          , Gs          , Ss          , Gs          
Ww          , Wwr         , Ww          , Hh          , Gg          , Ds          , Ww          , Re          , Wwf         , Gg          , Ww          , Gg          , Hh          , Hh          , Hh          , Gg          , Hh          , Gs^Fp       , Hh          , Gs^Fp       , Gg          , Re          , Re          , Gg          , Re          , Re          , Re          , Gg^Vh       , Gg          , Gg          , Gg          , Gg          , Hh          , Gg          , Gg          , Gg          , Re          , Re          , Chs         , Ss          , Gs^Ft       , Ss          
Ww          , Ww          , Ww          , Ww          , Ww          , Ww          , Ww          , Ww^Bw|      , Ww          , Ww          , Ww          , Ww          , Ww^Bw|      , Gg          , Gg          , Gg          , Gs^Fp       , Hh          , Gs^Fp       , Gs^Fp       , Gg          , Gg          , Re          , Re          , Ch          , Ch          , Ch          , Re          , Gg          , Gg          , Hh          , Hh          , Mm^Vhh      , Hh          , Gg          , Gg          , Re          , Gg          , Ss          , Ds          , Ss          , Ss          
Gg          , Hh          , Hh          , Ww          , Ww          , Ww          , Gg          , Ww^Bw|      , Gg          , Ww          , Ww          , Wo          , Wo          , Ww^Bw\      , Ww^Bw\      , Gg          , Gs^Fp       , Gg          , Gg          , Gg          , 1 Kh        , Gg          , Ch          , Rp          , Rp          , 2 Kh        , Ch          , Re          , Gg          , Gg          , Hh          , Mm          , Mm          , Hh          , Gg          , Re          , Gg          , Gs          , Ss^Bw\      , Ss          , Ss          , Ss          
Hh          , Hh          , Gs^Fp       , Gg          , Hh          , Gg          , Re          , Re          , Hh          , Gg          , Gg          , Ww          , Wo          , Wo          , Wo          , Ww^Bw\      , Gg          , Gg^Ve       , Gg          , Ch          , Rp          , Ch          , Rp          , Rp          , Rd          , Rp          , Rp          , Re          , Re          , Gg          , Gg          , Hh          , Gg          , Hh          , Gg          , Re          , Gg          , Ss          , Ss          , Gs^Ft       , Ss          , Ss          
Mm          , Hh          , Hh          , Gg          , Mm          , Hh          , Re          , Hh          , Mm          , Hh          , Hh          , Ww          , Ww          , Wo          , Wo          , Ww          , Ww          , Gg          , Ww          , Ch          , Rr          , Rp          , Rp          , Rp          , Rp          , Rp          , Ch          , Gg          , Gg          , Re          , Gg          , Gg          , Gg          , Gg          , Re          , Re          , Gg          , Gs          , Ww          , Ss          , Ww          , Wwr         
Mm          , Mm          , Mm          , Hh          , Hh          , Hh          , Re          , Hh          , Mm          , Mm          , Mm          , Hh          , Ww          , Wo          , Wo          , Ww          , Ww          , Ww          , Ww          , Ww          , Ww^Bw/      , Rr          , Rr          , Rp          , 3 Kh        , Ch          , Gg          , Gg          , Gg          , Re          , Re          , Re          , Re          , Re          , Gg          , Gg          , Ww          , Ww          , Ww          , Ww          , Gs          , Gg          
Hh          , Hh          , Gg          , Gg          , Gg^Vl       , Re          , Re          , Hh          , Hh^Vhh      , Mm          , Hh          , Hh          , Ww          , Ww          , Wo          , Wo          , Wo          , Wo          , Wo          , Ww          , Ww          , Wwr         , Rr          , Rp          , Ch          , Gg          , Gg^Vh       , Gg          , Gg          , Gg          , Gg          , Gg          , Gg          , Re          , Ww^Bw\      , Ww          , Ww          , Ww          , Ds          , Gs          , Gs^Ft       , Ss          
Hh          , Gg^Vl       , Re^Gvs      , Re^Gvs      , Re^Gvs      , Re^Gvs      , Re          , Re          , Hh          , Hh          , Gg          , Wwr         , Ww          , Wo          , Wo          , Wo          , Wo          , Wo          , Wo          , Ww          , Ww          , Ww^Bw/      , Ww          , Ch          , Gg          , Gg          , Gg          , Gg          , Ww          , Wwf         , Wwf         , Ww          , Ww          , Wwf         , Ww          , Ww^Bw\      , Re          , Gg          , Ss          , Ss          , Ss          , Ss          
Hh          , Gg          , Re^Gvs      , Re^Gvs      , Re          , Re          , Hh          , Gg          , Gg^Efm         , Hh          , Wwr         , Ww          , Wo          , Wo          , Wo          , Wo          , Wo          , Wo          , Wo          , Wo          , Wo          , Ww          , Ww          , Ww          , Ww          , Wwf         , Ww          , Ww          , Ww          , Ww          , Gg          , Ww          , Gg          , Ww          , Gs          , Gs          , Re          , Re          , Ss^Bw\      , Ss          , Ss          , Ss          
Hh          , Gg          , Gg^Vl       , Re^Gvs      , Re          , Ch          , Kh          , Hh          , Hh          , Hh          , Ww          , Ww          , Wo          , Wo          , Wo          , Wo          , Wo          , Wo          , Ww          , Ww          , Ww          , Ww          , Gg          , Ww          , Wwf         , Ww          , Ww          , Ww          , Gg          , Gg          , Gg          , Gg          , Ss          , Gs          , Ss          , Ss          , Re          , Gs^Ft       , Ss          , Ss^Bw|      , Ss          , Ss          
Hh          , Hh          , Hh          , Hh          , Re          , Ch          , Hh          , Hh          , Wwr         , Ww          , Wo          , Wo          , Ww          , Wo          , Wo          , Wo          , Wo          , Wo          , Ww          , Ww^Bw\      , Gg^Vh       , Gg          , Hh          , Gg          , Hh          , Gg          , Gg          , Gg          , Gg          , Gs          , Gg          , Ss          , Ss          , Gs^Ft       , Ss^Bw|      , Ss^Bw/      , Ss          , Ss          , Ss          , Gs^Vht      , Ss          , Ss          
Hh          , Hh          , Gg          , Hh          , Re          , Hh          , Hh          , Gg          , Ww          , Ww          , Wo          , Ww          , Gs^Fp       , Chw         , Khw         , Chw         , Ww          , Wo          , Wo          , Ww          , Gg          , Gg^Efm         , Hh          , Hh          , Hh          , Hh          , Hh          , Gg          , Gg          , Gs          , Gs          , Gs^Vht      , Gs          , Ss          , Re          , Ss          , Ss          , Ce          , Ke          , Ss^Bw|      , Ss          , Ss          
Hh          , Hh          , Hh          , Gg          , Re          , Gg          , Gg          , Gg          , Gs^Fp       , Ww          , Ww          , Ww          , Gs^Fp       , Hh          , Gg          , Wwf         , Ww          , Wo          , Wo          , Ww          , Wwr         , Gg          , Hh          , Gg          , Gg^Vh       , Gg          , Hh          , Gg          , Gs          , Gs          , Gs^Ft       , Gs          , Gs^Ft       , Re          , Gs          , Ss          , Ss          , Ce          , Ss^Bw/      , Gs^Ft       , Ss          , Ss          
Gg          , Hh          , Gg          , Gg          , Re          , Gg          , Gg^Efm         , Gs^Fp       , Hh          , Wwr         , Ww          , Ww          , Ww          , Gg          , Gg          , Gg^Ve       , Gs^Fp       , Wwf         , Ww          , Ww          , Ww          , Gg          , Hh          , Gg          , Gg          , Gg          , Gg          , Gg          , Gg          , Gg          , Gs^Ft       , Gs^Ft       , Gs          , Re          , Ds          , Ds          , Ss          , Ss^Bw|      , Gs^Vht      , Ss          , Gs^Ft       , Ss          
Gg          , Gg          , Gg          , Gg          , Gg          , Re          , Gs^Fp       , Gs^Fp       , Gs^Fp       , Hh          , Ww          , Wo          , Wo          , Ww          , Wwf         , Gg          , Gg          , Gs^Fp       , Ww          , Wo          , Ww          , Gg          , Hh          , Hh          , Hh          , Hh          , Hh          , Gg          , Gs^Fp       , Gs^Ft       , Gs^Ft       , Gg          , Gs^Ft       , Re          , Gs          , Gs^Ft       , Ss          , Ss^Bw\      , Ss          , Ss^Bw\      , Ss^Bw|      , Ss          
Hh          , Gs^Fp       , Gs^Fp       , Gs^Fp       , Gg          , Re          , Re          , Gg          , Gg^Ve       , Gs^Fp       , Gs^Fp       , Ww          , Ww          , Ww          , Ww          , Gs^Fp       , Ww^Bw|      , Wwf         , Wo          , Wo          , Ww          , Gg          , Gg          , Gg          , Hh          , Hh          , Gg          , Gg          , Gg          , Gg          , Gg          , Gg          , Gg          , Re          , Re          , Ds          , Rp          , Ss          , Gs^Ft       , Ss          , Ss^Bw/      , Ss          
Hh          , Hh          , Hh          , Gs^Fp       , Gg^Fet      , Gs^Fp       , Gg          , Re          , Gg          , Gs^Fp       , Gg          , Gg          , Ww^Bw/      , Ww^Bw\      , Ww^Bw\      , Ww^Bw/      , Ww          , Ww          , Ww          , Ww          , Ww          , Ww          , Ww          , Gg          , Gg          , Gg          , Gs^Fp       , Gs^Fp       , Gg          , Gg          , Gs^Fp       , Gs          , Gs^Ft       , Gs^Ft       , Gs^Ft       , Re          , Re          , Ss          , Ss          , Ss^Bw|      , Ss          , Ss          
Gg          , Gs^Fp       , Gg          , Gs^Fp       , Gs^Fp       , Gs^Fp       , Gs^Fp       , Re          , Re          , Gg^Efm         , Gg          , Re          , Gg          , Wwf         , Ww          , Ww          , Ww          , Ww          , Gg          , Gg          , Gg          , Ww          , Ww          , Wwf         , Gg          , Gg          , Gs^Fp       , Gs^Fp       , Gg          , Hh          , Hh          , Gs          , Hh          , Gg          , Gg          , Gs          , Re          , Gs          , Gs^Ft       , Gs^Ft       , Ss          , Ss          
Hh          , Gg^Efm         , Gg          , Gg^Ve       , Gg          , Gs^Fp       , Gs^Fp       , Gs^Fp       , Gg          , Re          , Re          , Re          , Gg          , Gg^Efm         , Gg          , Ww          , Wwf         , Ww          , Gg          , Hh          , Gg          , Gg          , Wwf         , Ww          , Ww          , Gg          , Gg          , Gg          , Gg^Vh       , Hh          , Hh          , Gg          , Gg          , Gs          , Re          , Re          , Gs^Vht      , Re          , Re          , Gg          , Ss          , Ss          
Re          , Gg          , Re          , Gg          , Gg^Efm         , Gg          , Gg          , Gg          , Gg          , Gg          , Re          , Gg          , Gg          , Gg          , Gs^Fp       , Gg          , Gs^Fp       , Gg          , Gg          , Hh          , Hh          , Gg          , Gg          , Ww          , Ww          , Wwf         , Gg          , Gg          , Gg          , Gg          , Gg          , Gg          , Re          , Re          , Gg          , Gg          , Gs^Ft       , Gs          , Gg          , Re          , Gs          , Gs          
Gg          , Re          , Hh          , Re          , Re          , Re          , Re          , Gg          , Gg          , Re          , Gg          , Gg          , Gs^Fp       , Gs^Fp       , Hh          , Gs^Fp       , Gs^Fp       , Gs^Fp       , Gg          , Hh          , Hh          , Gg          , Gg^Vh       , Gg          , Ww          , Ww          , Ww^Bw/      , Re          , Re          , Re          , Re          , Re          , Gg          , Gs^Fp       , Hh          , Gs^Ft       , Gs^Fp       , Gs          , Gs          , Re          , Re          , Ds          
Gg          , Gg          , Gg          , Gg          , Gg          , Gg          , Gg          , Re          , Re          , Re          , Re          , Gg          , Gg          , Gs^Fp       , Gs^Fp       , Hh          , Gs^Fp       , Gs^Fp       , Gg          , Gg          , Gg          , Hh          , Gg          , Gg          , Re          , Ww^Bw/      , Ww          , Gg          , Gg          , Hh          , Hh          , Gg          , Gg          , Gs^Fp       , Gs^Fp       , Hh          , Gs^Fp       , Hh          , Gs^Ft       , Gg          , Hh          , Re          
Hh          , Gg          , Gs^Fp       , Gg^Efm         , Gg^Ve       , Gs^Fp       , Gs^Fp       , Gg          , Gg          , Gg          , Gg          , Re          , Re          , Gg          , Gg          , Gs^Fp       , Gg          , Gs^Fp       , Gg          , Gg          , Re          , Gg          , Re          , Re          , Chw         , Ww          , Ww          , Gg          , Hh          , Hh          , Hh          , Gg          , Gs          , Gs          , Hh          , Gg          , Hh          , Gs^Fp       , Gs^Ft       , Gs^Ft       , Gs^Ft       , Gg          
Hh          , Gs^Fp       , Gs^Fp       , Gs^Fp       , Gs^Fp       , Gs^Fp       , Gg          , Gg          , Gs^Fp       , Gs^Fp       , Gs^Fp       , Gs^Fp       , Gg          , Re          , Gg          , Gg^Ve       , Gg          , Gg          , Re          , Re          , Gg          , Re          , Gg          , Khw         , Wo          , Ww          , Gg          , Hh          , Hh          , Gg          , Gs          , Gs          , Gs^Ft       , Gs^Ft       , Gs^Fp       , Hh          , Hh          , Hh          , Gs          , Hh          , Hh          , Hh          
Gg          , Gg          , Gg          , Gs^Fp       , Cv          , Cv          , Gs^Fp       , Gg^Efm         , Gs^Fp       , Gs^Fp       , Gg^Fet      , Gs^Fp       , Gg          , Re          , Re          , Gg          , Re          , Re          , Gg          , Gg          , Gg          , Chr         , Gs          , Chw         , Ww          , Ww          , Gg          , Gg          , Gg          , Gs          , Gs          , Gs^Vht      , Ds          , Gs          , Gs          , Gs          , Gs          , Ds          , Ds          , Ds          , Hd          , Ds          
Gs^Fp       , Gg          , Gs^Fp       , Gs^Fp       , Hh          , Kv          , Hh          , Gs^Fp       , Gg^Ve       , Gs^Fp       , Gs^Fp       , Gs^Fp       , Gs^Fp       , Gg^Efm         , Gg          , Re          , Gs^Fp       , Gg          , Gg          , Hh          , Hh          , Gg^Vh       , Wwf         , Ww          , Ww          , Wwf         , Gg          , Gg          , Gg          , Gs          , Gg          , Ds          , Hd          , Ds          , Dd^Vdt      , Ds          , Ds          , Dd^Do       , Ds          , Dd^Vdt      , Ds          , Hd          
Gs^Fp       , Gs^Fp       , Gg^Fet      , Gg          , Hh          , Gg          , Gs^Fp       , Gg^Efm         , Gs^Fp       , Hh          , Hh          , Gs^Fp       , Gg          , Gg          , Gg^Efm         , Re          , Gs^Fp       , Gs^Fp       , Gg          , Hh          , Hh          , Gg          , Ww          , Ww          , Gg          , Gg          , Ds          , Ds          , Ds          , Ds          , Hd          , Ds          , Ds          , Ds          , Ds          , Ds          , Ds          , Ds          , Ds          , Ds          , Ds          , Ds          
Gg          , Gs^Fp       , Gs^Fp       , Gs^Fp       , Gs^Fp       , Gs^Fp       , Gg          , Gs^Fp       , Gs^Fp       , Gs^Fp       , Gs^Fp       , Gs^Fp       , Gg          , Gs^Fp       , Gs^Fp       , Re          , Gg          , Gs^Fp       , Gg          , Hh          , Gg          , Hh          , Wo          , Ww          , Gg          , Ds          , Hd          , Ds          , Hd          , Ds          , Ds          , Ds          , Ds          , Ds          , Hd          , Ds          , Ds          , Hd          , Ds          , Ds          , Ds          , Ds          
