border_size=1
usage=map

Xuc         , Xuc         , Xuc         , Xuc         , Xuc         , Xuc         , Xuc         , Xuc         , Xuc         , Xuc         , Xuc         , Xuc         , Xuc         , Xuc         , Xuc         , Xuc         , Xuc         , Xuc         , Xuc         , Xuc         , Xuc         , Xuc         , Xuc         , Xuc         , Xuc         , Xuc         , Xuc         , Xuc         , Xuc         , Xuc         , Xuc         , Xuc         , Xuc         , Xuc         
Xuc         , Xuc         , Xuc         , Xuc         , Xuc         , Xuc         , Xuc         , Xuc         , Xuc         , Xuc         , Xuc         , Xuc         , Xuc         , Xuc         , Xuc         , Xuc         , Xuc         , Xuc         , Xuc         , Xuc         , Xuc         , Xuc         , Xuc         , Xuc         , Xuc         , Xuc         , Xuc         , Xuc         , Xuc         , Xuc         , Xuc         , Xuc         , Xuc         , Xuc         
Xuc         , Xuc         , Xuc         , Xuc         , Xuc         , Xuc         , Xuc         , Xuc         , Xuc         , Xuc         , Xuc         , Xuc         , Qlf         , Xuc         , Xuc         , Xuc         , Xuc         , Xuc         , Xuc         , Xuc         , Xuc         , Xuc         , Qlf         , Xuc         , Xuc         , Xuc         , Xuc         , Xuc         , Xuc         , Xuc         , Xuc         , Xuc         , Xuc         , Xuc         
Xuc         , Xuc         , Xuc         , Xuc         , Xuc         , Xuc         , Xuc         , Xuc         , Xuc         , Xuc         , Qlf         , Qlf         , Qxu^Xo      , Qlf         , Qlf         , Xuc         , Xuc         , Xuc         , Xuc         , Xuc         , Qlf         , Qlf         , Qxu^Xo      , Qlf         , Qlf         , Xuc         , Xuc         , Xuc         , Xuc         , Xuc         , Xuc         , Xuc         , Xuc         , Xuc         
Xuc         , Xuc         , Xuc         , Xuc         , Xuc         , Xuc         , Xuc         , Xuc         , Xuc         , Xuc         , Qlf         , Qxu^Xo      , Ai^Ii       , Qxu^Xo      , Qlf         , Xuc         , Ce          , Rr^Vud      , Ce          , Xuc         , Qlf         , Qxu^Xo      , Ai^Ii       , Qxu^Xo      , Qlf         , Xuc         , Xuc         , Xuc         , Xuc         , Xuc         , Xuc         , Xuc         , Xuc         , Xuc         
Xuc         , Xuc         , Xuc         , Xuc         , Xuc         , Xuc         , Xuc         , Xuc         , Xuc         , Xuc         , Qlf         , Qxu^Xo      , Qxu^Xo      , Qxu^Xo      , Qxu^Xo      , Xuc         , Gs^Vht      , Ce          , Gg^Vc       , Xuc         , Qxu^Xo      , Qxu^Xo      , Qxu^Xo      , Qxu^Xo      , Qlf         , Xuc         , Xuc         , Xuc         , Xuc         , Xuc         , Xuc         , Xuc         , Xuc         , Xuc         
Xuc         , Xuc         , Xuc         , Xuc         , Xuc         , Xuc         , Xuc         , Xuc         , Xuc         , Xuc         , Xuc         , Qlf         , Qxu^Xo      , Qxu^Xo      , Qxu^Xo      , Xuc         , Ss^Bw|      , Ds^Fds      , Ss^Bw|      , Xuc         , Qxu^Xo      , Qxu^Xo      , Qxu^Xo      , Qlf         , Xuc         , Xuc         , Xuc         , Xuc         , Xuc         , Xuc         , Xuc         , Xuc         , Xuc         , Xuc         
Xuc         , Xuc         , Xuc         , Xuc         , Xuc         , Xuc         , Xuc         , Xuc         , Xuc         , Xuc         , Ce          , Xuc         , Xuc         , Qxu^Xo      , Gs^Fp       , Qxu^Xo      , Wwf^Bw|     , Wwrg        , Wwf^Bw|     , Qxu^Xo      , Ai^Ft       , Qxu^Xo      , Xuc         , Xuc         , Ce          , Xuc         , Xuc         , Xuc         , Xuc         , Xuc         , Xuc         , Xuc         , Xuc         , Xuc         
Xuc         , Xuc         , Xuc         , Xuc         , Xuc         , Xuc         , Xuc         , Xuc         , Xuc         , Rd^Do       , Ke          , Gs          , Ss^Bw\      , Qxu^Xo      , Uh^Ii       , Xuc         , Gg^Ve       , Wwf         , Gs^Vht      , Xuc         , Ha^Ii       , Qxu^Xo      , Ss^Bw/      , Gs          , Ke          , Rd^Do       , Xuc         , Xuc         , Xuc         , Xuc         , Xuc         , Xuc         , Xuc         , Xuc         
Xuc         , Xuc         , Xuc         , Xuc         , Xuc         , Xuc         , Xuc         , Xuc         , Xuc         , Ce          , Gs          , Ce          , Wwrg        , Xu          , Qxu^Xo      , Xuc         , Cud         , 3 Kud       , Cud         , Xuc         , Qxu^Xo      , Xuc         , Wwrg        , Ce          , Gs          , Ce          , Xuc         , Xuc         , Xuc         , Xuc         , Xuc         , Xuc         , Xuc         , Xuc         
Xuc         , Xuc         , Xuc         , Xuc         , Xuc         , Xuc         , Qlf         , Qlf         , Qlf         , Xuc         , Xuc         , Ss^Bw\      , Xu          , Xu          , Rp^Fet      , Xuc         , Xuc         , Cud         , Xuc         , Xuc         , Rp^Fet      , Xuc         , Xuc         , Ss^Bw/      , Xuc         , Xuc         , Qlf         , Qlf         , Qlf         , Xuc         , Xuc         , Xuc         , Xuc         , Xuc         
Xuc         , Xuc         , Xuc         , Xuc         , Xuc         , Qlf         , Qxu^Xo      , Qxu^Xo      , Qxu^Xo      , Qxu^Xo      , Qxu^Xo      , Qxu^Xo      , Ha^Ii       , Qxu^Xo      , Xuc         , Rp^Br\      , Rp^Br\      , Xuc         , Rp^Br/      , Rp^Br/      , Xuc         , Qxu^Xo      , Uh^Ii       , Qxu^Xo      , Qxu^Xo      , Qxu^Xo      , Qxu^Xo      , Qxu^Xo      , Qxu^Xo      , Qlf         , Xuc         , Xuc         , Xuc         , Xuc         
Xuc         , Xuc         , Xuc         , Xuc         , Xuc         , Qlf         , Qxu^Xo      , Ai^Ii       , Qxu^Xo      , Qxu^Xo      , Qxu^Xo      , Ai^Ft       , Xuc         , Xuc         , Cud         , Xuc         , Xuc         , Rp^Br|      , Xuc         , Xuc         , Cud         , Xuc         , Xuc         , Gs^Fp       , Qxu^Xo      , Qxu^Xo      , Qxu^Xo      , Ai^Ii       , Qxu^Xo      , Qlf         , Xuc         , Xuc         , Xuc         , Xuc         
Xuc         , Xuc         , Xuc         , Xuc         , Xuc         , Qlf         , Qlf         , Qxu^Xo      , Qlf         , Qxu^Xo      , Xuc         , Qxu^Xo      , Wwf^Bw/     , Gs^Ve       , 2 Kud       , Cud         , Xuc         , Rp^Br|      , Xuc         , Cud         , 1 Kud       , Gs^Vht      , Wwf^Bw\     , Qxu^Xo      , Xuc         , Qxu^Xo      , Qlf         , Qxu^Xo      , Qlf         , Qlf         , Xuc         , Xuc         , Xuc         , Xuc         
Xuc         , Xuc         , Xuc         , Xuc         , Xuc         , Xuc         , Xuc         , Qlf         , Xuc         , Xuc         , Gs^Vc       , Ss^Bw/      , Wwrg        , Wwf         , Gs^Vh       , Cud         , Xuc         , Rp^Br|      , Xuc         , Cud         , Gs^Vh       , Wwf         , Wwrg        , Ss^Bw\      , Gs^Vht      , Xuc         , Xuc         , Qlf         , Xuc         , Xuc         , Xuc         , Xuc         , Xuc         , Xuc         
Xuc         , Xuc         , Xuc         , Xuc         , Xuc         , Xuc         , Xuc         , Xuc         , Xuc         , Ce          , Ce          , Ds^Fds      , Ss^Bw/      , Wwf^Bw/     , Xuc         , Xuc         , Qxu         , Rp^Fet      , Qxu         , Xuc         , Xuc         , Wwf^Bw\     , Ss^Bw\      , Ds^Fds      , Ce          , Ce          , Xuc         , Xuc         , Xuc         , Xuc         , Xuc         , Xuc         , Xuc         , Xuc         
Xuc         , Xuc         , Xuc         , Xuc         , Xuc         , Xuc         , Xuc         , Xuc         , Xuc         , Rr^Vud      , Ce          , Gs^Vht      , Xuc         , Qxu^Xo      , Gs^Fp       , Uh^Ii       , Xuc         , Xuc         , Xuc         , Ha^Ii       , Ai^Ft       , Qxu^Xo      , Xuc         , Gs^Vc       , Ce          , Rr^Vud      , Xuc         , Xuc         , Xuc         , Xuc         , Xuc         , Xuc         , Xuc         , Xuc         
Xuc         , Xuc         , Xuc         , Xuc         , Xuc         , Xuc         , Xuc         , Xuc         , Xuc         , Xuc         , Xuc         , Xuc         , Qxu^Xo      , Qxu^Xo      , Qxu^Xo      , Qxu^Xo      , Ss^Bw|      , Wwrg        , Ss^Bw|      , Qxu^Xo      , Qxu^Xo      , Qxu^Xo      , Qxu^Xo      , Xuc         , Xuc         , Xuc         , Xuc         , Xuc         , Xuc         , Xuc         , Xuc         , Xuc         , Xuc         , Xuc         
Xuc         , Xuc         , Xuc         , Xuc         , Xuc         , Xuc         , Xuc         , Xuc         , Xuc         , Xuc         , Qlf         , Qlf         , Qxu^Xo      , Qxu^Xo      , Qxu^Xo      , Xuc         , Gs          , Ce          , Gs          , Xuc         , Qxu^Xo      , Qxu^Xo      , Qxu^Xo      , Qlf         , Qlf         , Xuc         , Xuc         , Xuc         , Xuc         , Xuc         , Xuc         , Xuc         , Xuc         , Xuc         
Xuc         , Xuc         , Xuc         , Xuc         , Xuc         , Xuc         , Xuc         , Xuc         , Xuc         , Xuc         , Qlf         , Qxu^Xo      , Ai^Ii       , Qxu^Xo      , Qlf         , Xuc         , Ce          , Ke          , Ce          , Xuc         , Qlf         , Qxu^Xo      , Ai^Ii       , Qxu^Xo      , Qlf         , Xuc         , Xuc         , Xuc         , Xuc         , Xuc         , Xuc         , Xuc         , Xuc         , Xuc         
Xuc         , Xuc         , Xuc         , Xuc         , Xuc         , Xuc         , Xuc         , Xuc         , Xuc         , Xuc         , Qlf         , Qxu^Xo      , Qxu^Xo      , Qxu^Xo      , Qlf         , Xuc         , Xuc         , Rd^Do       , Xuc         , Xuc         , Qlf         , Qxu^Xo      , Qxu^Xo      , Qxu^Xo      , Qlf         , Xuc         , Xuc         , Xuc         , Xuc         , Xuc         , Xuc         , Xuc         , Xuc         , Xuc         
Xuc         , Xuc         , Xuc         , Xuc         , Xuc         , Xuc         , Xuc         , Xuc         , Xuc         , Xuc         , Xuc         , Qlf         , Qlf         , Qlf         , Xuc         , Xuc         , Xuc         , Xuc         , Xuc         , Xuc         , Xuc         , Qlf         , Qlf         , Qlf         , Xuc         , Xuc         , Xuc         , Xuc         , Xuc         , Xuc         , Xuc         , Xuc         , Xuc         , Xuc         
Xuc         , Xuc         , Xuc         , Xuc         , Xuc         , Xuc         , Xuc         , Xuc         , Xuc         , Xuc         , Xuc         , Xuc         , Xuc         , Xuc         , Xuc         , Xuc         , Xuc         , Xuc         , Xuc         , Xuc         , Xuc         , Xuc         , Xuc         , Xuc         , Xuc         , Xuc         , Xuc         , Xuc         , Xuc         , Xuc         , Xuc         , Xuc         , Xuc         , Xuc         
Xuc         , Xuc         , Xuc         , Xuc         , Xuc         , Xuc         , Xuc         , Xuc         , Xuc         , Xuc         , Xuc         , Xuc         , Xuc         , Xuc         , Xuc         , Xuc         , Xuc         , Xuc         , Xuc         , Xuc         , Xuc         , Xuc         , Xuc         , Xuc         , Xuc         , Xuc         , Xuc         , Xuc         , Xuc         , Xuc         , Xuc         , Xuc         , Xuc         , Xuc         
Xuc         , Xuc         , Xuc         , Xuc         , Xuc         , Xuc         , Xuc         , Xuc         , Xuc         , Xuc         , Xuc         , Xuc         , Xuc         , Xuc         , Xuc         , Xuc         , Xuc         , Xuc         , Xuc         , Xuc         , Xuc         , Xuc         , Xuc         , Xuc         , Xuc         , Xuc         , Xuc         , Xuc         , Xuc         , Xuc         , Xuc         , Xuc         , Xuc         , Xuc         
Xuc         , Xuc         , Xuc         , Xuc         , Xuc         , Xuc         , Xuc         , Xuc         , Xuc         , Xuc         , Xuc         , Xuc         , Xuc         , Xuc         , Xuc         , Xuc         , Xuc         , Xuc         , Xuc         , Xuc         , Xuc         , Xuc         , Xuc         , Xuc         , Xuc         , Xuc         , Xuc         , Xuc         , Xuc         , Xuc         , Xuc         , Xuc         , Xuc         , Xuc         
