Gg, Gg, Gg, Re, Hh, Hh, Hh, Hh, Mm^Xm, Mm^Xm, Mm^Xm, Ds, Ss, Hh, Ss, Ss, Ss, Hh, Ss, Ss, Ss, Ds, Mm^Xm, Mm^Xm, Mm^Xm, Hh, Hh, Hh, Hh, Re, Gg, Gg, Gg
Gg, Gg, 4 Gg^Vh, Re, Gg, Gg, Gg, Hh, Mm^Xm, Xu, Mm^Xm, Ss, Ss, Mm, Ss, Gs^Ft, Ss, Mm, Ss, Gs^Ft, Ss, Ss, Mm^Xm, Xu, Mm^Xm, Hh, Gg, Gg, Gg, Re, 3 Gg^Ve, Gg, Gg
Re, Gg, Re, Re, Ce, Gg, Gg, Hh, Hd, Mm^Xm, Ss, Ss, Gs^Ft, Ss, Ss, Ss, Ss^Vhs, Ss, Ss, Ss, Gs^Ft, Ss, Ss, Mm^Xm, Hd, Hh, Gg, Gg, Ce, Re, Re, Gg, Re
Gs^Fp, Re, Re, Ce, Ke, Ce, Mm, Gs^Fp, Ss, Ss, Mm, Hh, Gs^Ft, Ss, Hh, Gs^Fp, Wwf, Hh, Gs^Fp, Ss, Gs^Ft, Hh, Mm, Ss, Ss, Gs^Fp, Mm, Ce, Ke, Ce, Re, Re, Gs^Fp
Re^Tf, Gs^Fp, Wwf, Ce, Ce, Ce, Ss, Ss, Gs^Ft, Hh, Gs^Ft, Gs^Ft, Gs^Fp, Mm, Mm^Xm, Dd, Wwf, Dd, Mm^Xm, Mm, Gs^Fp, Gs^Ft, Gs^Ft, Hh, Gs^Ft, Ss, Ss, Ce, Ce, Ce, Wwf, Gs^Fp, Re^Tf
Uh, Uu^Tf, Uu, Wwf, Wwf, Wwf, Wwf, Ss, Hh, Gs^Ft, Gs^Vht, Hh, Mm^Xm, Mm^Xm, Rd, Rd, Wwf, Rd, Rd, Mm^Xm, Mm^Xm, Hh, Gs^Vht, Gs^Ft, Hh, Ss, Wwf, Wwf, Wwf, Wwf, Uu, Uu^Tf, Uh
Uh, Uh, Uu, Uu^Ii, Wwf, Ss, Hh, Wwf, Wwf, Gs, Gs, Mm, Rd, Rd, Ww, Ww, Ww^Vm, Ww, Ww, Rd, Rd, Mm, Gs, Gs, Wwf, Wwf, Hh, Ss, Wwf, Uu^Ii, Uu, Uh, Uh
Xu, Uu^Vud, Re, Uu, Ss, Ss, Gs, Gs, Gs, Rd, Rd, Rd, Ww, Ww, Ww^Bw/, Ww^Bw/, Ww^Bw|, Ww^Bw\, Ww^Bw\, Ww, Ww, Rd, Rd, Rd, Gs, Gs, Gs, Ss, Ss, Uu, Re, Uu^Vu, Xu
Xu, Xu, Re, Uu^Tf, Gs^Ft, Gs^Ft, Hd, Chw, Chw, Gs, Wwf, Wwf, Gg, Gg, Ww^Bw\, Ss, Rd, Ss, Ww^Bw/, Gg, Gg, Wwf, Wwf, Gs, Chw, Chw, Hd, Gs^Ft, Gs^Ft, Uu^Tf, Re, Xu, Xu
Xu, Xu, Uh, Re, Dd^Vdt, Rd, Dd, Kh, Wwf, Ww, Gg, Re, Ww, Ss, Dd, Ce, Rd, Ce, Dd, Ss, Ww, Re, Gg, Ww, Wwf, Kh, Dd, Rd, Dd^Vdt, Re, Uh, Xu, Xu
Xu, Xu, Uu, Uu, Wwf, Dd, Ww, Wwf, Wwf, Gg, Wwf, Wwf, Gs^Vht, Dd, Gs^Ft, Hd, Wwf, Gs^Ft, Hd, Dd, Gs^Vht, Wwf, Wwf, Gg, Wwf, Wwf, Ww, Dd, Wwf, Uu, Uu, Xu, Xu
Uh, Uu, Cud, Cud, Ww, Wwf, Gs, Mm, Wwf, Wwf, Ss, Re, Re, Hd, Gs^Ft, Ss, Chs, Ss, Hd, Gs^Ft, Re, Re, Ss, Wwf, Wwf, Mm, Gs, Wwf, Ww, Cud, Cud, Uu, Uh
Uu^Tf, Uu^Tf, Uh, Ww, Gs^Ft, Hd, Wwf, Wwf, Hd, Rd, Ss^Vhs, Hh, Ww^Bw|, Ww^Bw\, Ww^Bw\, Ss, Wwf, Ss, Ww^Bw/, Ww^Bw/, Ww^Bw|, Gs^Ft, Ss^Vhs, Rd, Gs^Ft, Wwf, Wwf, Gs^Ft, Hd, Ww, Uh, Uu^Tf, Uu
Uu, Uu, Ww, Wwf, Wwf, Wwf, Dd^Vdt, Dd, Re, Rd, Chs, Gs^Ft, Re, Ce, Wwf, Hh, Ss^Vhs, Gs^Ft, Wwf, Ce, Re, Hh, Chs, Rd, Re, Dd, Dd^Vdt, Wwf, Wwf, Wwf, Ww, Uu, Uu
Wwf, Wwf, Mm, Ss, Hd, Gs^Ft, Re, Re, Ss, Wwf, Ww^Bw/, Re, Md, Dd, Wwf, Gs^Ft, Ss, Hh, Wwf, Dd, Md, Re, Ww^Bw\, Wwf, Ss, Re, Re, Hd, Gs^Ft, Ss, Mm, Wwf, Wwf
Ww, Ww, Hh, Gs^Ft, Re, Re, Gs^Ft, Hd, Ww^Bw/, Ww^Bw/, Ss, Hd, Gg, Re, Re, Ss, Dd, Ss, Re, Re, Gg, Hd, Ss, Ww^Bw\, Ww^Bw\, Gs^Ft, Hd, Re, Re, Hh, Gs^Ft, Ww, Ww
Ss, Ss, Ss^Vhs, Re, Dd^Do, Ds, Chs, Re, Ww^Vm, Wwf, Mm, Gs^Ft, Dd, Hh, Dd^Vda, Re, Chs, Re, Dd^Vda, Hh, Dd, Gs^Ft, Mm, Wwf, Ww^Vm, Re, Chs, Ds, Dd^Do, Re, Ss^Vhs, Ss, Ss
Ww, Ss, Gs^Ft, Re, Re, Ds, Hd, Re, Ww^Bw\, Wwf, Ss, Hh, Gg, Gs^Ft, Re, Re, Dd, Re, Re, Gs^Ft, Gg, Hh, Ss, Wwf, Ww^Bw/, Re, Gs^Ft, Ds, Re, Re, Hh, Ss, Ww
Wwf, Ww, Mm, Hh, Gs^Ft, Re, Re, Gs^Ft, Ss, Ww^Bw\, Ww^Bw\, Gs^Ft, Md, Re, Wwf, Ss, Ss, Ss, Wwf, Re, Md, Gs^Ft, Ww^Bw/, Ww^Bw/, Ss, Hd, Re, Re, Hd, Gs^Ft, Mm, Ww, Wwf
Uu, Wwf, Ww, Ss, Wwf, Hd, Dd^Vda, Re, Re, Wwf, Chs, Re, Re, Dd, Wwf, Gs^Ft, Ss^Vhs, Hh, Wwf, Dd, Re, Re, Chs, Wwf, Re, Re, Dd^Vda, Gs^Ft, Wwf, Ss, Ww, Wwf, Uu
Uu, Uu, Uh, Wwf, Hd, Wwf, Wwf, Dd, Gs^Ft, Rd, Ss^Vhs, Hh, Ww^Bw|, Ce, Ww^Bw/, Hh, Wwf, Gs^Ft, Ww^Bw\, Ce, Ww^Bw|, Gs^Ft, Ss^Vhs, Rd, Hd, Dd, Wwf, Wwf, Gs^Ft, Wwf, Uh, Uu, Uu
Uh, Uu^Tf, Cud, Ww, Ww, Gs^Ft, Gs, Wwf, Wwf, Rd, Ss, Gs^Ft, Re, Ww^Bw/, Gs^Ft, Ss, Chs, Ss, Hd, Ww^Bw\, Re, Hh, Ss, Rd, Wwf, Wwf, Gs, Hd, Ww, Ww, Cud, Uu^Tf, Uh
Xu, Uu, Uu, Cud, Wwf, Wwf, Ww, Mm, Wwf, Wwf, Wwf, Re, Gs^Vht, Hd, Gs^Ft, Ss, Wwf, Ss, Hd, Gs^Ft, Gs^Vht, Re, Wwf, Wwf, Wwf, Mm, Ww, Wwf, Wwf, Cud, Uu, Uu, Xu
Xu, Xu, Uh, Uu, Dd^Vdt, Dd, Dd, Wwf, Wwf, Gg, Gg, Wwf, Ww, Dd, Dd, Hd, Rd, Gs^Ft, Dd, Dd, Ww, Wwf, Gg, Gg, Wwf, Wwf, Dd, Dd, Dd^Vdt, Uu, Uh, Xu, Xu
Xu, Xu, Re, Re, Gs^Ft, Rd, Hd, Kh, Chw, Ww, Wwf, Re, Gg, Ss, Ww^Bw/, Ce, Rd, Ce, Ww^Bw\, Ss, Gg, Re, Wwf, Ww, Chw, Kh, Hd, Rd, Gs^Ft, Re, Re, Xu, Xu
Xu, Xu, Re, Uu^Tf, Ss, Gs^Ft, Gs, Chw, Gs, Gs, Rd, Wwf, Ww, Gg, Ww^Bw\, Ss, Ww^Bw|, Ss, Ww^Bw/, Gg, Ww, Wwf, Rd, Gs, Gs, Chw, Gs, Gs^Ft, Ss, Uu^Tf, Re, Xu, Xu
Uh, Uu^Vu, Uu, Uu, Wwf, Ss, Hh, Gs, Wwf, Rd, Gs, Rd, Rd, Ww, Ww, Ww^Bw\, Ww^Vm, Ww^Bw/, Ww, Ww, Rd, Rd, Gs, Rd, Wwf, Gs, Hh, Ss, Wwf, Uu, Uu, Uu^Vud, Uh
Uh, Uh, Uu, Uu^Ii, Wwf, Ss, Wwf, Wwf, Hh, Gs, Gs^Vht, Mm, Mm^Xm, Rd, Rd, Ww, Wwf, Ww, Rd, Rd, Mm^Xm, Mm, Gs^Vht, Gs, Hh, Wwf, Wwf, Ss, Wwf, Uu^Ii, Uu, Uh, Uh
Re^Tf, Uu^Tf, Wwf, Wwf, Ce, Wwf, Ss, Ss, Gs^Ft, Gs^Ft, Gs^Ft, Hh, Gs^Fp, Mm^Xm, Mm^Xm, Rd, Wwf, Rd, Mm^Xm, Mm^Xm, Gs^Fp, Hh, Gs^Ft, Gs^Ft, Gs^Ft, Ss, Ss, Wwf, Ce, Wwf, Wwf, Uu^Tf, Re^Tf
Gs^Fp, Gs^Fp, Re, Ce, Ke, Ce, Mm, Ss, Ss, Hh, Mm, Gs^Ft, Gs^Ft, Mm, Gs^Fp, Dd, Wwf, Dd, Hh, Mm, Gs^Ft, Gs^Ft, Mm, Hh, Ss, Ss, Mm, Ce, Ke, Ce, Re, Gs^Fp, Gs^Fp
Re, Re, Re, Ce, Ce, Ce, Gg, Gs^Fp, Hd, Ss, Ss, Hh, Ss, Ss, Ss, Hh, Ss^Vhs, Gs^Fp, Ss, Ss, Ss, Hh, Ss, Ss, Hd, Gs^Fp, Gg, Ce, Ce, Ce, Re, Re, Re
Gg, Gg, 2 Gg^Ve, Re, Gg, Gg, Gg, Hh, Mm^Xm, Mm^Xm, Mm^Xm, Ss, Gs^Ft, Ss, Mm, Ss, Ss, Ss, Gs^Ft, Ss, Mm, Ss, Mm^Xm, Mm^Xm, Mm^Xm, Hh, Gg, Gg, Gg, Re, 5 Gg^Ve, Gg, Gg
Gg, Gg, Gg, Re, Hh, Hh, Hh, Hh, Mm^Xm, Xu, Mm^Xm, Ds, Ss, Ss, Hh, Ss, Ss, Ss, Ss, Ss, Hh, Ds, Mm^Xm, Xu, Mm^Xm, Hh, Hh, Hh, Hh, Re, Gg, Gg, Gg
