border_size=1
usage=map

_off^_usr, _off^_usr, _off^_usr, _off^_usr, _off^_usr, _off^_usr, _off^_usr, _off^_usr, _off^_usr, _off^_usr, _off^_usr, _off^_usr, _off^_usr, _off^_usr, _off^_usr, _off^_usr, _off^_usr, _off^_usr, _off^_usr, _off^_usr, _off^_usr, _off^_usr, _off^_usr, _off^_usr, _off^_usr, _off^_usr, _off^_usr, _off^_usr, _off^_usr, _off^_usr, _off^_usr, _off^_usr, _off^_usr, _off^_usr, _off^_usr, _off^_usr, _off^_usr, _off^_usr, _off^_usr, _off^_usr, _off^_usr, _off^_usr, _off^_usr, _off^_usr, _off^_usr, _off^_usr
_off^_usr, _off^_usr, _off^_usr, _off^_usr, _off^_usr, _off^_usr, _off^_usr, _off^_usr, _off^_usr, _off^_usr, _off^_usr, _off^_usr, _off^_usr, _off^_usr, _off^_usr, _off^_usr, _off^_usr, _off^_usr, _off^_usr, _off^_usr, _off^_usr, _off^_usr, _off^_usr, _off^_usr, _off^_usr, _off^_usr, _off^_usr, _off^_usr, _off^_usr, _off^_usr, _off^_usr, _off^_usr, _off^_usr, _off^_usr, _off^_usr, _off^_usr, _off^_usr, _off^_usr, _off^_usr, _off^_usr, Xuc, _off^_usr, _off^_usr, _off^_usr, _off^_usr, _off^_usr
_off^_usr, _off^_usr, _off^_usr, _off^_usr, _off^_usr, _off^_usr, _off^_usr, _off^_usr, _off^_usr, _off^_usr, Ss^Vhs, _off^_usr, _off^_usr, _off^_usr, _off^_usr, _off^_usr, _off^_usr, _off^_usr, _off^_usr, _off^_usr, _off^_usr, _off^_usr, _off^_usr, _off^_usr, _off^_usr, _off^_usr, Ss^Vhs, _off^_usr, _off^_usr, _off^_usr, _off^_usr, _off^_usr, _off^_usr, _off^_usr, _off^_usr, _off^_usr, _off^_usr, _off^_usr, Gg^Efm, Xuc, 2 Kud, Xuc, Gg^Efm, _off^_usr, _off^_usr, _off^_usr
_off^_usr, _off^_usr, _off^_usr, _off^_usr, _off^_usr, _off^_usr, _off^_usr, _off^_usr, Gs, Ce, 6 Ke, Ce, Ss, _off^_usr, _off^_usr, _off^_usr, _off^_usr, _off^_usr, _off^_usr, _off^_usr, _off^_usr, _off^_usr, _off^_usr, _off^_usr, Gs, Ce, 4 Ke, Ce, Ss, _off^_usr, _off^_usr, _off^_usr, _off^_usr, _off^_usr, _off^_usr, _off^_usr, _off^_usr, _off^_usr, Gg^Efm, Xuc, Xuc, Xuc, Gg^Efm, _off^_usr, _off^_usr, _off^_usr
_off^_usr, _off^_usr, _off^_usr, _off^_usr, Xu, Xu, Gs, Gs, Gs, Gs, Ce, Gs, Gs, Ss, Ss, Xu, Xu, _off^_usr, _off^_usr, _off^_usr, Xu, Xu, Gs, Gs, Gs, Gs, Ce, Gs, Gs, Ss, Ss, Xu, Xu, _off^_usr, _off^_usr, _off^_usr, _off^_usr, _off^_usr, _off^_usr, Gg^Efm, Gg^Wm, Gg^Efm, _off^_usr, _off^_usr, _off^_usr, _off^_usr
_off^_usr, _off^_usr, _off^_usr, _off^_usr, Xu, Xu, Xu, Ss, Ss^Vhs, Re^Uf, Re, Ce, Gs, Gs^Ft, Xu, Xu, Xu, _off^_usr, _off^_usr, _off^_usr, Xu, Xu, Xu, Ss, Ss^Vhs, Re^Uf, Re, Ce, Gs, Gs^Ft, Xu, Xu, Xu, _off^_usr, _off^_usr, _off^_usr, _off^_usr, _off^_usr, _off^_usr, Gg^Efm, Rp, Gg^Efm, _off^_usr, _off^_usr, _off^_usr, _off^_usr
_off^_usr, _off^_usr, _off^_usr, _off^_usr, Xu, Uu, Xu, Wwf, Wwf, Gs, Gs^Ft, Re, Gs, Hh, Xu, Uu, Xu, _off^_usr, _off^_usr, _off^_usr, Xu, Uu, Xu, Wwf, Wwf, Gs, Gs^Ft, Re, Gs, Hh, Xu, Uu, Xu, _off^_usr, _off^_usr, _off^_usr, _off^_usr, _off^_usr, _off^_usr, Gg^Efm, Rp, Gg^Efm, _off^_usr, _off^_usr, _off^_usr, _off^_usr
_off^_usr, _off^_usr, _off^_usr, Xu, Uu, Uh, Xu, Ds, Ww, Ds, Ss, Re, Hh, Gs^Vht, Xu, Uu^Uf, Uu, Xu, _off^_usr, Xu, Uu, Uh, Xu, Ds, Ww, Ds, Ss, Re, Hh, Gs^Vht, Xu, Uu^Uf, Uu, Xu, _off^_usr, _off^_usr, _off^_usr, _off^_usr, _off^_usr, Gg^Efm, Rp, Gg^Efm, _off^_usr, _off^_usr, _off^_usr, _off^_usr
_off^_usr, _off^_usr, _off^_usr, Xu, Xu, Xu, Gg, Re^Uf, Wwf, Ss^Vm, Wwf, Ww^Bw|, Wwf, Gs, Gs, Xu, Xu, Xu, _off^_usr, Xu, Xu, Xu, Gg, Re^Uf, Wwf, Ss^Vm, Wwf, Ww^Bw|, Wwf, Gs, Gs, Xu, Xu, Xu, _off^_usr, _off^_usr, _off^_usr, _off^_usr, Gg^Efm, Gg^Efm, Rp, Gg^Efm, _off^_usr, _off^_usr, _off^_usr, _off^_usr
_off^_usr, _off^_usr, _off^_usr, Xu, Gg, Gg, Gg, Gg, Hh, Wwf, Gg, Gg, Wwf, Ds, Wwf, Gs, Gs, Xu, _off^_usr, Xu, Gg, Gg, Gg, Gg, Hh, Wwf, Gg, Gg, Wwf, Ds, Wwf, Gs, Gs, Xu, _off^_usr, _off^_usr, Gg^Efm, Gg^Efm, Rp, Rp, Gg^Efm, Gg^Efm, _off^_usr, _off^_usr, _off^_usr, _off^_usr
_off^_usr, _off^_usr, _off^_usr, Gg, Hh, Gg, Gg, Chr, Gs^Fp, Gg, Gg^Vc, Rr, Chw, Ww, Gs^Fp, Ww, Wwf, Ds, _off^_usr, Gg, Hh, Gg, Gg, Chr, Gs^Fp, Gg, Gg^Vc, Gg, Chw, Ww, Gs^Fp, Ww, Wwf, Ds, _off^_usr, Gg^Efm, Rp, Rp, Gg^Efm, Gg^Efm, _off^_usr, _off^_usr, _off^_usr, _off^_usr, _off^_usr, _off^_usr
_off^_usr, _off^_usr, _off^_usr, Gs^Fp, Hh^Vhh, Re^Gvs, _off^_usr, _off^_usr, _off^_usr, _off^_usr, _off^_usr, _off^_usr, _off^_usr, _off^_usr, _off^_usr, Gg, Gg, Ww, _off^_usr, Gs^Fp, Hh^Vhh, Re^Gvs, _off^_usr, _off^_usr, _off^_usr, _off^_usr, _off^_usr, _off^_usr, _off^_usr, _off^_usr, _off^_usr, Gg, Gg, Ww, _off^_usr, Gg^Efm, Rp, Gg^Efm, _off^_usr, _off^_usr, _off^_usr, _off^_usr, _off^_usr, _off^_usr, _off^_usr, _off^_usr
_off^_usr, _off^_usr, _off^_usr, Gg, Gg, Re^Gvs, _off^_usr, Gg^Efm, Gg^Efm, Gg^Efm, _off^_usr, Cud, Cud, Cud, _off^_usr, Gg^Ve, Gs^Fp, Gg, _off^_usr, Gg, Gg, Re^Gvs, _off^_usr, Cud, Cud, Cud, _off^_usr, Cud, Cud, Cud, _off^_usr, Gg^Ve, Gs^Fp, Gg, _off^_usr, Gg^Efm, Rp, Gg^Efm, _off^_usr, Cud, Cud, Cud, _off^_usr, _off^_usr, _off^_usr, _off^_usr
_off^_usr, _off^_usr, _off^_usr, Wwf, Wwf, Gg, _off^_usr, Gg^Efm, Cv, Gg^Efm, _off^_usr, Aa^Fpa, Ai, Aa^Vha, _off^_usr, Hh, Rr, Rr, _off^_usr, Wwf, Wwf, Gg, _off^_usr, Aa, Aa^Fpa, Aa, _off^_usr, Aa^Fpa, Ai, Aa^Vha, _off^_usr, Hh, Rr, Rr, _off^_usr, Gg^Efm, Rp, Gg^Efm, _off^_usr, Aa, Aa^Fpa, Aa, _off^_usr, _off^_usr, _off^_usr, _off^_usr
_off^_usr, _off^_usr, _off^_usr, Ai, Wo, Gg, _off^_usr, Gg^Efm, Rp, Gg^Efm, _off^_usr, Ai, Wwf, Ai, _off^_usr, Gg, Gg, Chw, _off^_usr, Ai, Wo, Gg, _off^_usr, Ai, Ai, Ha, _off^_usr, Ai, Wwf, Ai, _off^_usr, Gg, Gg, Chw, _off^_usr, Gg^Efm, Ww^Bw|, Gg^Efm, _off^_usr, Ai, Ai, Ha, _off^_usr, _off^_usr, _off^_usr, _off^_usr
_off^_usr, _off^_usr, _off^_usr, Aa^Vea, Ai, Ww, _off^_usr, Ww, Ww^Bw|, Ww, _off^_usr, Ww, Gg, Ww, _off^_usr, Ww, Wwf, Ww, _off^_usr, Aa^Vea, Ai, Ww, _off^_usr, Ww, Wo, Aa^Vea, _off^_usr, Ww, Gg, Ww, _off^_usr, Ww, Wwf, Ww, _off^_usr, Ww, Rp, Ww, _off^_usr, Ww, Wo, Aa^Vea, _off^_usr, _off^_usr, _off^_usr, _off^_usr
_off^_usr, _off^_usr, _off^_usr, Ha, Aa^Fpa, Ai, _off^_usr, Gg^Efm, Rp, Gg^Efm, _off^_usr, Chw, Rr, Gg, _off^_usr, Ai, Ai, Ai, _off^_usr, Ha, Aa^Fpa, Ai, _off^_usr, Gg, Wwf, Ai, _off^_usr, Chw, Rr, Gg, _off^_usr, Ai, Ai, Ai, _off^_usr, Gg^Efm, Cv, Gg^Efm, _off^_usr, Gg, Wwf, Ai, _off^_usr, _off^_usr, _off^_usr, _off^_usr
_off^_usr, _off^_usr, _off^_usr, Aa, Cud, Aa, _off^_usr, Gg^Efm, Rp, Gg^Efm, _off^_usr, Rr, Gs^Fp, Hh, _off^_usr, Aa^Vha, Cud, Aa^Fpa, _off^_usr, Aa, Cud, Aa, _off^_usr, Gg, Gg, Wwf, _off^_usr, Rr, Gs^Fp, Hh, _off^_usr, Aa^Vha, Cud, Aa^Fpa, _off^_usr, Gg^Efm, Gg^Efm, Gg^Efm, _off^_usr, Gg, Gg, Wwf, _off^_usr, _off^_usr, _off^_usr, _off^_usr
_off^_usr, _off^_usr, _off^_usr, Cud, _off^_usr, Cud, _off^_usr, Gg^Efm, Rp, Gg^Efm, _off^_usr, Gg, Gg, Gg^Ve, _off^_usr, Cud, _off^_usr, Cud, _off^_usr, Cud, _off^_usr, Cud, _off^_usr, Re^Gvs, Hh^Vhh, Gg, _off^_usr, Gg, Gg, Gg^Ve, _off^_usr, Cud, _off^_usr, Cud, _off^_usr, Gg^Efm, _off^_usr, Gg^Efm, _off^_usr, Re^Gvs, Hh^Vhh, Gg, _off^_usr, _off^_usr, _off^_usr, _off^_usr
_off^_usr, _off^_usr, _off^_usr, _off^_usr, _off^_usr, _off^_usr, Gg^Efm, Gg^Efm, Rp, Gg^Efm, _off^_usr, Ww, Wwf, Gg, Gs^Fp, _off^_usr, Chw, _off^_usr, Gg^Vc, _off^_usr, Gs^Fp, _off^_usr, Gg, Re^Gvs, Hh, Gs^Fp, _off^_usr, Ww, Wwf, Gg, Gs^Fp, _off^_usr, Chw, _off^_usr, Gg^Vc, _off^_usr, Gs^Fp, _off^_usr, Gg, Re^Gvs, Hh, Gs^Fp, _off^_usr, _off^_usr, _off^_usr, _off^_usr
_off^_usr, _off^_usr, _off^_usr, _off^_usr, Gg^Efm, Gg^Efm, Rp, Rp, Gg^Efm, Gg^Efm, _off^_usr, Ds, Gs, Ww, Wwf, Ww, Wwf, Rr, Gg, Gg, Hh, Chr, Gg, Gg, Gg, Gg, _off^_usr, Ds, Gs, Ww, Wwf, Ww, Wwf, Rr, Gg, Gg, Hh, Chr, Gg, Gg, Gg, Gg, _off^_usr, _off^_usr, _off^_usr, _off^_usr
_off^_usr, _off^_usr, _off^_usr, Gg^Efm, Rp, Rp, Gg^Efm, Gg^Efm, _off^_usr, _off^_usr, _off^_usr, Xu, Xu, Gs, Gs, Ds, Wwf, Gg, Wwf, Wwf, Wwf, Gg, Gg, Gg, Xu, Xu, _off^_usr, Xu, Xu, Gs, Gs, Ds, Wwf, Gg, Wwf, Wwf, Wwf, Gg, Gg, Gg, Xu, Xu, _off^_usr, _off^_usr, _off^_usr, _off^_usr
_off^_usr, _off^_usr, _off^_usr, Gg^Efm, Rp, Gg^Efm, _off^_usr, _off^_usr, _off^_usr, _off^_usr, _off^_usr, Xu, Uu, Xu, Xu, Gs, Hh, Ww^Bw|, Ss, Ss^Vm, Ww, Re^Uf, Xu, Xu, Uu, Xu, _off^_usr, Xu, Uu, Xu, Xu, Gs, Hh, Ww^Bw|, Ss, Ss^Vm, Ww, Re^Uf, Xu, Xu, Uu, Xu, _off^_usr, _off^_usr, _off^_usr, _off^_usr
_off^_usr, _off^_usr, _off^_usr, Gg^Efm, Rp, Gg^Efm, _off^_usr, _off^_usr, _off^_usr, _off^_usr, _off^_usr, Xu, Xu, Uu^Uf, Xu, Gs^Vht, Gs, Re, Gs^Ft, Ds, Wwf, Ds, Xu, Uh, Xu, Xu, _off^_usr, Xu, Xu, Uu^Uf, Xu, Gs^Vht, Gs, Re, Gs^Ft, Ds, Wwf, Ds, Xu, Uh, Xu, Xu, _off^_usr, _off^_usr, _off^_usr, _off^_usr
_off^_usr, _off^_usr, _off^_usr, Gg^Efm, Rp, Gg^Efm, _off^_usr, _off^_usr, _off^_usr, _off^_usr, _off^_usr, _off^_usr, Xu, Uu, Xu, Hh, Gs, Re, Re, Gs, Ss^Vhs, Wwf, Xu, Uu, Xu, _off^_usr, _off^_usr, _off^_usr, Xu, Uu, Xu, Hh, Gs, Re, Re, Gs, Ss^Vhs, Wwf, Xu, Uu, Xu, _off^_usr, _off^_usr, _off^_usr, _off^_usr, _off^_usr
_off^_usr, _off^_usr, _off^_usr, Gg^Efm, Gg^Wm, Gg^Efm, _off^_usr, _off^_usr, _off^_usr, _off^_usr, _off^_usr, _off^_usr, Xu, Xu, Ss, Gs^Ft, Gs, Ce, Ce, Re^Uf, Gs, Ss, Gs, Xu, Xu, _off^_usr, _off^_usr, _off^_usr, Xu, Xu, Ss, Gs^Ft, Gs, Ce, Ce, Re^Uf, Gs, Ss, Gs, Xu, Xu, _off^_usr, _off^_usr, _off^_usr, _off^_usr, _off^_usr
_off^_usr, _off^_usr, Gg^Efm, Gg^Efm, Xuc, Gg^Efm, Gg^Efm, _off^_usr, _off^_usr, _off^_usr, _off^_usr, _off^_usr, _off^_usr, Xu, _off^_usr, Ss, Ss, Gs, 3 Ke, Gs, Gs, Gs, _off^_usr, Xu, _off^_usr, _off^_usr, _off^_usr, _off^_usr, _off^_usr, Xu, _off^_usr, Ss, Ss, Gs, 5 Ke, Gs, Gs, Gs, _off^_usr, Xu, _off^_usr, _off^_usr, _off^_usr, _off^_usr, _off^_usr, _off^_usr
_off^_usr, _off^_usr, Gg^Efm, Xuc, 1 Kud, Xuc, Gg^Efm, _off^_usr, _off^_usr, _off^_usr, _off^_usr, _off^_usr, _off^_usr, _off^_usr, _off^_usr, _off^_usr, _off^_usr, Ce, Ss^Vhs, Ce, _off^_usr, _off^_usr, _off^_usr, _off^_usr, _off^_usr, _off^_usr, _off^_usr, _off^_usr, _off^_usr, _off^_usr, _off^_usr, _off^_usr, _off^_usr, Ce, Ss^Vhs, Ce, _off^_usr, _off^_usr, _off^_usr, _off^_usr, _off^_usr, _off^_usr, _off^_usr, _off^_usr, _off^_usr, _off^_usr
_off^_usr, _off^_usr, _off^_usr, Xuc, Xuc, Xuc, _off^_usr, _off^_usr, _off^_usr, _off^_usr, _off^_usr, _off^_usr, _off^_usr, _off^_usr, _off^_usr, _off^_usr, _off^_usr, _off^_usr, _off^_usr, _off^_usr, _off^_usr, _off^_usr, _off^_usr, _off^_usr, _off^_usr, _off^_usr, _off^_usr, _off^_usr, _off^_usr, _off^_usr, _off^_usr, _off^_usr, _off^_usr, _off^_usr, _off^_usr, _off^_usr, _off^_usr, _off^_usr, _off^_usr, _off^_usr, _off^_usr, _off^_usr, _off^_usr, _off^_usr, _off^_usr, _off^_usr
_off^_usr, _off^_usr, _off^_usr, _off^_usr, _off^_usr, _off^_usr, _off^_usr, _off^_usr, _off^_usr, _off^_usr, _off^_usr, _off^_usr, _off^_usr, _off^_usr, _off^_usr, _off^_usr, _off^_usr, _off^_usr, _off^_usr, _off^_usr, _off^_usr, _off^_usr, _off^_usr, _off^_usr, _off^_usr, _off^_usr, _off^_usr, _off^_usr, _off^_usr, _off^_usr, _off^_usr, _off^_usr, _off^_usr, _off^_usr, _off^_usr, _off^_usr, _off^_usr, _off^_usr, _off^_usr, _off^_usr, _off^_usr, _off^_usr, _off^_usr, _off^_usr, _off^_usr, _off^_usr
